Operon number 1:
thrA: MQNVFCVLPIFWKAMPGRGRWPPSSLPPPKSPTTWWR*
thrB: MLYPISAMPNVFLPNF*
thrC: MSCMALVCWGSARIASTLR*

Operon number 2:
yaaY: MAQDSTSLRGVNTAFPR*
ribF: MKLIRGIHNLSQAPQEGCVLTIGNFDGVHRGHRALLQGLQEEGRKRNLPVMVMLFEPQPLELFATDKAPARLTRLREKLRYLAECGVDYVLCVRFDRRFAALTAQNFISDLLVKHLRVKFLAVGDDFRFGAGREGDFLLLQKAGMEYGFDITSTQTFCEGGVRISSTAVRQALADDNLALAESLLGHPFAISGRVVHGDELGRTIGFPTANVPLRRQVSPVKGVYAVEVLGLGEKPLPGVANIGTRPTVAGIRQQLEVHLLDVAMDLYGRHIQVVLRKKIRNEQRFASLDELKAQIARDELTAREFFGLTKPA*

Operon number 3:
ileS: MMICTASSVRLKKAKKPSFCMMALLMRMAAFILVTRLTRF*
lspA: MTRRMCLAGTATVCRSS*

Operon number 4:
fkpB: MAPPPSLPATTVNRRCSAWVMLLFLKGWSNTCWG*
ispH: MRRLACRHRT*

Operon number 5:
carA: MSAPMTPMKNLLRYMHKVW*
carB: MAALSRAITRMRRWR*

Operon number 6:
fixA: MNRILRSIMLMVH*
fixB: MPK*

Operon number 7:
fixC: MPTVWNTLFLVSPTPPP*
fixX: MKNSRL*

Operon number 8:
kefF: MRIRIRIIPMRINGCLNRQGRWKASKFALFINSILTSISILPPSRRRCLAPI*
kefC: MAARRCMANICCGR*

Operon number 9:
ilvI: MMHCIPWVVLIMY*
ilvH: MSRRRCIWPMAWRARPGKSASCW*

Operon number 10:
mraZ: MPANVRWMAQVDC*
rsmH: MPG*
ftsL: MKQPGINRSRKISTQSSWLPETYRSDCRTCLYKMMENYKHTTVLLDEAVNGLNIRPDGIYIDGTFGRGGHSRLILSQLGEEGRLLAIDRDPQAIAVAKTIDDPRFSIIHGPFSALGEYVAERDLIGKIDGILLDLGVSSPQLDDAERGFSFMRDGPLDMRMDPTRGQSAAEWLQTAEEADIAWVLKTYGEERFAKRIARAIVERNREQPMTRTKELAEVVAAATPVKDKFKHPATRTFQAVRIWVNSELEEIEQALKSSLNVLAPGGRLSIISFHSLEDRIVKRFMRENSRGPQVPAGLPMTEEQLKKLGGRQLRALGKLMPGEEEVAENPRARSSVLRIAERTNA*
ftsI: MHCLVLSVTIFCDLGSCHSACSFALF*
murE: ML*
murF: MRSATIAGWKGSPRKSCKCSMLIRHKKIS*
mraY: MPTLSVGVLRCYAAVFSWRWLFCSDA*
murD: MTLAVSASVTAGRRWLTRSIFRWISFQPALTPTRKGALFIWRVR*
ftsW: MVA*
murG: MNACRRWFIAN*

Operon number 11:
murC: MKVIRSVVPI*
ddlB: MPAWSLFPARFLPITRKLSPLMKRVFR*
ftsQ: MASPLPERTAKRQPPRWFPASTQKRGSTQPSLTAGW*
ftsA: MRVWGMVGT*

Operon number 12:
ampD: MTKHPPCWWCTILACRQASLAVRGSTHYSLELLIRRHILSLLRSPICASPLTV*
ampE: MVK*

Operon number 13:
aceE: MTWIRSKLATGSRRSNRSSVKKVLSVLSI*
aceF: MMCALTTSSVHATSRMAATWFTSRATSPRACTLVLSWKVV*

Operon number 14:
yadG: MRFSGRTGPGNRPLSVLSALW*
yadH: MS*

Operon number 15:
fhuC: MPNRWKAGAAKRLPAKWLICRSSFLRQKG*
fhuD: MARWGALGRQIAKKSRKLSRWLA*
fhuB: MCCRWCTV*

Operon number 16:
ispU: MAAVMLRSLWTAMAAGQKSKGRFVPLGIKPGQNPSAGLSLLRPTTVLRR*
cdsA: MPLVVKTGTDQRRKSVR*
rseP: MKRC*
bamA: MSVCMNWPL*

Operon number 17:
skp: MSSKAVPANCSVWKPICRLK*
lpxD: MQTPLLTTAAM*

Operon number 18:
fabZ: MSLSMSHSSRAISLENRFSRVC*
lpxA: MVK*
lpxB: MSKLVRVPY*
rnhB: MVILKLAAIMRFISSPPSAKLTRI*
dnaE: MLANRPVWKSAIVTAFAKASPFIVAQSRAVD*
accA: MSLRRVTTQRRSVSISKG*

Operon number 19:
yaeQ: MWPISTATSFSMPL*
arfB: MLMNVCNLPVVCVPMMSRKRGCVTITWALICGLSWGCRMSGGLRKPAPRPQKWRCLPIIVGRRKSGGSKIRANVCSLPIFPSGIWTMNNWRK*
nlpE: MA*

Operon number 20:
yafD: MPCAMLPDNLRKGSYRRGLLRASARHYHLGNR*
yafE: MHIWCYCRKRRQRQS*

Operon number 21:
yafN: MI*
yafO: MMISMTLRNKDAGIQNKTYSPATYSRGT*
yafP: MVAHCHSET*

Operon number 22:
proB: MALTLP*
proA: MPITTNARVLFFIFIPDFN*

Operon number 23:
mmuP: MAESAPCGTRKSLFWSDGAYC*
mmuM: MSWRPFLYLIINPHPLLSARRGHLRLVQG*

Operon number 24:
yagE: MSGSGNGAECAGGPEDRRHLPEPSAGATCSRWQVKCRSDGRGNGCSPRPARRTKQTQYVMTWYLSHPRA*
yagF: MSPDRTPQRGEGTAPSHLFPLAPLGRGPG*

Operon number 25:
yagG: MVVIGGGPSGTGMEETYQLTSALKHISWGKTVSLITDARFSGVSTGACFGHVSPEALAGGPIGKLRDNDIIEIAVDRLTLTGSVNFIGTADNPLTPEEGARELARRQTHPDLHAHDFLPDDTRLWAALQSVSGGTWKGCIYDTDKIIEVINAGKKALGI*

Operon number 26:
insE1: MGNTTVTADNNVEKNVASFAANAGTFLSSQPDSDATRNFITGMATAKANQEIQEWLGKYGTARVKLNVDKDFSLKDSSLEMLYPIYDTPTNMLFTQGAIHRTDDRTQSNIGFGWRHFSGNDWMAGVNTFIDHDLSRSHTRIGVGAEYWRDYLKLSANGYIRASGWKKSPDIEDYQERPANGWDIRAEGYLPAWPQLGASLMYEQYYGDEVGLFGKDKRQKDPHAISAEVTYTPVPLTQQ*

Operon number 27:
ykgE: MSRASFAQLFRDVSGTTPLAVLTKLRLQIAAQMFSRETLPVVVIAESVGYASESSFHKAFVREFGCTPGEYRERVRQLAP*
ykgF: MDFLCQK*
ykgG: MRGGMLLAN*

Operon number 28:
yahD: MPRKPPGIKDSNQKRPCQTTTAEKGTVVITLAQNADSPLTEASQPAVSAAKNAHTIPE*
yahE: MVPNNSHP*
yahF: MVNRVRTTSSYWWRLKNCSTPKRKAARTRRVTPLLAAPKSISRKVTWR*
yahG: MNWRSSNWPTKKGC*

Operon number 29:
yahI: MATAPAIVALVGGTVEEAIDFSRQMREITLGENPNVTIPLLGFMGVPSAIDITRVGSSGILPVINTAIAHKDAGVGMIGAGIVHPPFACFEKAILGWCERYGV*
yahJ: MRRERLIRPTNGARICRPDKRSASGICHHCRMRRERLIRPTNGARICRPDKRSASGICHHCRMRRGRLIRPTSGARICRPDKRSASGICHHCRMRRERLIRPTSGARIVGLISVAHQAVWRWS*

Operon number 30:
prpC: MYRQFADAVQVPILANITEFGATPLFTTDELRSAHVAMALYPLSAFRAMNRAAEHVYNVLRQEGTQKSVIDTMQTRNELYESINYYQYEEKLDNLFARSQVK*
prpD: MPDASLTRLIRPTRCTEL*
prpE: MPDAPLT*

Operon number 31:
codB: M*
codA: MR*

Operon number 32:
cynT: MRLLPYDNRRVVCLSFQRQTEVNGERDY*

Operon number 33:
mhpA: MQAAEFRQQPDAGTAIKFI*
mhpB: MAGAGL*
mhpC: METGVGYPGESPRCAARYLSTRTSRSRQSDD*
mhpD: MQSTVGDERRANPAVARVGHTLHSGGAGSANSYRTG*
mhpF: MSTRRKRCSMRSMA*
mhpE: MT*

Operon number 34:
insC1: MFSFIITTPLGKIKKQRCVFNFRHQFSIR*
insD1: MIARIIGKIVARGNGS*

Operon number 35:
tauA: MRHSLILYRQDVRQ*
tauB: MFLCNSYVKCLYVWYV*
tauC: M*
tauD: MRVIENDTVIYTMRI*

Operon number 36:
sbmA: MTPHTARQKKADYVSTVVSID*
yaiW: MKVTERIYTTH*

Operon number 37:
tgt: MTARHGALFEVEFNDERSVLDILNSIGHMPLPPYIDRPDEDADRELYQTVYSEKPGAVAAPTAGLHFDEPLLEKLRAKGVEMAFVTLHVGAGTFQPVRVDTIEDHIMHSEYAEVPQDVVDAVLAAKARGNRVIAVGTTSVRSLESAAQAAKNDLIEPFFDDTQIFIYPGFQYKVVDALVTNFHLPESTLIMLVSAFAGYQHTMNAYKAAVEEKYRFFSYGDAMFITYNPQAINERVGE*
yajC: MPANSGRQTALPDGRW*
secD: MREI*
secF: MR*

Operon number 38:
nrdR: MTGKDVAGRTKSSRNTFTA*
ribD: MRARDHSTHPEYVV*

Operon number 39:
ribE: MRTGFPYIQLKLGASLDGRTAMASGESQWITSPQARRDVQLLRAQSHAILTSSATVLADDPALTVRWSELDEQTQALYPQQNLRQPIRIVIDSQNRVTPVHRIVQQPGETWFARTQEDSREWPETVRTLLIPEHKGHLDLVVLMMQLGKQQINSIWVEAGPTLAGALLQAGLVDELIVYIAPKLLGSDARGLCTLPGLEKLADAPQFKFKEIRHVGPDVCLHLVGA*

Operon number 40:
thiL: MLNTSSWLNRM*
pgpA: MCHTKWPLTKRSNWRNRSAQKTAISSSTAYSIKQHL*

Operon number 41:
ybaO: MIYLRMSRSWCCISNGIPEPACISSMTTVGLPGKRSLRCCRHLSIAVFVIR*
mdlA: MSKKCHSAASPRSASVAITTILHACRSSYTKH*
mdlB: MR*

Operon number 42:

Operon number 43:
ybaB: MQQKEVVATPKALKKALEHEKTPELAAKLAAEAIERDPWAAQVSQLSLPKLVEQVALNAWKEESDNAVCLHLRSSQRHLNNRGAQQKLAEALSMLKGSTVELTIVEDDNPAVRTPLEWRQAIYEEKLAQARESIIADNNIQTLRRFFDAELDEESIRPI*

Operon number 44:
glsA: MTPPAV*
ybaT: MRHNPLV*

Operon number 45:

Operon number 46:
ybbA: MKTLAF*
ybbP: MSHDLLKAATASPSSRQ*

Operon number 47:
rhsD: MLLLLAQVQVGMRQRHQELVVWRTLGAGKKLLRTTLWCEFAMLGFVSGLVAAIGAETALAVLQAKVFDFPWEPDWRLWIVLPCSGALLLSLFGGWLGARLVKGKALFRQFAG*
ybbC: MMLLNW*

Operon number 48:
gcl: MSSPSPGRLCAA*
hyi: MSRSVTAMKRY*

Operon number 49:
ybbY: MKRYRNAVCLCQCSAN*
glxK: MPTSSSFSRIAAMFLPMTIWNIATKSARMLAVPLARVSRKPSYVVM*

Operon number 50:
ylbF: MRYAVDYAAMNDHRLWLKGFASGVSRLNSHSVIVCCVLRRLRILNHLQLHGCNARRKPGFSGHWRWRQAIRCLLSYASFVTVFRPRSMALRPTGGTGWVKAPD*
ybcF: MMTR*

Operon number 51:
sfmC: MLPL*
sfmD: MAVQFTLKANW*
sfmH: MLPVQ*
sfmF: MLLVIPLH*

Operon number 52:
insE1: MRHRHCSPNTKPISASASSIFSMNSGTISSKLAMYFSFRSITT*
insF1: MRGS*

Operon number 53:
ybcL: MNGIVFKHYPLMKVISAQQAISALKYMVDGEIYF*
ybcM: MISDFKLCYGDKVQDRINYL*

Operon number 54:
ylcH: MLYLPIDLIESFQKLYTVTDQIRNKTSFFLPQNPELIYCWEQLKTSVSRGFSTKIQEHLAMGVLLSLGVNHVNHLLLSYSKQSLISRCYNLLLSEPGTKWTANKVARYLYISVSTLHRRLASEGVSFQSILDDVRLNNALSAIQTTVKPISEIARENGYKCPSRFTERFHNRFNITPREIRKASRE*
ybcN: MLSHGA*
ninE: MATPLIRVMNGHIYRVPNRRKRKPELKPSEIPTLLGYTASLVDKKWLRLAARRSHG*

Operon number 55:
essD: MALG*
rrrD: MAPQQVVPGTGFYSC*

Operon number 56:
cusF: MPRLTNIIMKP*
cusB: MR*
cusA: MPMKRVLRLVCALTRLRRRIWG*

Operon number 57:
fes: M*
ybdZ: MNLLVHCFIPAFLPRIATVGHGRHQHDASRYRENL*
entF: MSALPTARHYAIANANSYQ*

Operon number 58:
entC: MCATAVSNLTRPVSGLNCGYS*
entE: MRIHQ*
entB: MIIIIKAFIILWRMIWIRHWLRKYSRPWQHLRPIAFSLCRRTAVLRRQDVSPASMNRL*
entA: MPKRRASKIR*
entH: MWWNARQFRSKPRLNRWLPAPPHLPPRRRSTKWCCHG*

Operon number 59:
dpiB: MLFNVAN*
dpiA: M*

Operon number 60:
ybeR: MRRVSCFEQRLFRLHKDRPDCFARHYGLVMQLVCTRKMPAHSLLRLRCHFCTSTQDYFAHKTFRSPRLSDTRQPLLYNWGLLHDPVSSQGRWKRKYGLVGQLFSARRWLAHYLYDGFYPRYTFALRNTVLHNDLAQRPASASKRLFRRPENQLRYRDYNKTQQYIEPRNRLFQHVR*
djlB: MNI*

Operon number 61:
ybeU: MPVDDGGPGCLGIIKIIFYIFIFAGLIGKILHLFG*
djlC: MCGKPGK*

Operon number 62:
seqA: MPGFSPNLQYADTDPTIPAR*
pgm: MLLCRSAVHPEYQQDPAPSPGNSLPDLSVKDRGYAYQPG*

Operon number 63:
rhsC: MELYREYPAWLIFLRRTYAVAAGVLALPFMLFWKDRARFYSYLHRVWSKTSDKPVWMDQAEKATGDFY*
ybfB: MSR*

Operon number 64:
ybgA: MVILKMVFLFTIPLPELYPVSVLRNFMRALLTGCLTTILQMIKTSSQLMEKYTGILMTRVAVRERFMSLVRSQQCTVWSSDRSRRIRNPMRSQLSLNFLTCWILKEKSSKPMRWVARKILQRRYKNREVIIYSL*
phr: MTVTQLVKRVTAEKKPVFILFAMSLMSLLISRLNRKGSYG*

Operon number 65:
ybgI: MRLPRTLSAKKPPRIGVTYTSEQ*
ybgJ: MP*
ybgK: MQYAV*
ybgL: MVCRWKAKRRCKKLLPVSPPARLCSMRQCVWARMRSLCIMATSGKESLRSFAE*
nei: MISTCMAGICRLTHILSWAITHSWRRYWGSRSWAKLSRWCRGAN*

Operon number 66:
sdhC: MLFLVMFVTTLLNDCQIR*
sdhD: MLLS*
sdhA: MTRSYRKDAV*
sdhB: M*

Operon number 67:
sucA: MRNMRKLSLTC*
sucB: MDKIRQLASIYRCQSSAKNSTGCMNVFSAHVVQPLVRLSGGIPISLSARQAC*

Operon number 68:
sucC: MRR*
sucD: MNIRQNNFLPAMAYQHRWVMPVLLRAKQKKPLQKSVPVRG*

Operon number 69:
mngA: MISCSLRSITIFFTSSIK*
mngB: MTCQVRSGNNASGIQVSSSAIGFCLR*

Operon number 70:
cydA: MM*
cydB: MPLLVILKLCVVLASDQKKN*
ybgT: MSLKLPY*
ybgE: MINIICRN*

Operon number 71:
ybgC: MQLPAS*
tolQ: MDSGNASCLFVWGNHRAGA*
tolR: MSKIIATLYAVMDKRPLRALSFVMALLLAGCMFWDPSRFAAKTSELEIWHGLLLMWAVCAGVIHGVGFRPQKVLWQGIFCPLLADIVLIVGLIFFFF*

Operon number 72:
tolB: MIFSVS*
pal: MHRKRGEGRKGTMLRLPGVVILKTMAHQGPISITMPGRLNLLSKVSSMTHRPMQAKPVRCA*
ybgF: MVCYWISNLKVAIPHFVRLRWQQLNLRRSRNHQARQYMKCSKTRHWTSNRNRDVDCSDGQHQAPVATGFW*

Operon number 73:
nadA: MSVELGVK*
pnuC: MSVLTLSL*

Operon number 74:
modA: MASQALL*
modB: MEPESAMCFSSEMRRGSANNFCWSLRVRRISACITMSWQKSYCDGKRTPRKADRTKGECFSVLSG*
modC: MTISGVDHVRVIKKSGIRRNHGTCRDGHHPGSDLRSW*

Operon number 75:
bioB: MVHAHPACALDNRLNDHRRDFMTMRRHQAGKAHHIALIPFAIHAALRGGSKQVFWQVAFPQTVH*
bioF: MITIAEGQKTLARFAFGLPVLQRHFHRHFHRYGTGVREKNALQRLRRHRHQFAAQLNGWRMGDTAKHHMRHGINLRLHRRIKLRVIVAVDRRPPGRHTVNQASAVRQNQLATFGAHHRINRQRGGHGCVWVPDMALVKGKIVRCHNRLVNQIEKI*
bioC: MPGSKSVLAALWA*
bioD: MMSMPLILFAPLRSRGS*

Operon number 76:
moaA: MASRGRTLR*
moaB: MPPSERRIRPVEPPLSVVVTIPVKREPKDESDERTRPSPCPPPRATTRSRSASVRLRI*
moaC: MMYIKVKPPFSLIL*
moaD: MTLYT*
moaE: MHLRVSFTTCACRLPMCVTFVAPTACRMATNRAASPIKAFLPSMKFAGLRAPSPDWAPKKCA*

Operon number 77:
dinG: MRYAYQAYVNSAIY*
ybiB: MLL*

Operon number 78:
mntR: MKAGVKRRTATPLFIGRFILLRFVVDHIAQHREQH*
ybiR: MTKHAHTPLELIHKTS*

Operon number 79:
iaaA: MVWLTGKGFTGNGQRLPGGNIG*
gsiA: MSEKRHRLYATSGVALGPAFTCHIHLSIFKN*
gsiB: MSNS*
gsiC: MVAQVQLAARR*
gsiD: MW*

Operon number 80:
yliE: MKAGGIG*
yliF: MCCLPSRVFYWRSLLLRCWEAALLT*

Operon number 81:
ybjC: MKGAFRAAGHPEIGLLFFILPGAVASFFSQRREVLKPLFGAMLAAPCSMLIMRLFFSPTRSFWQELAWLLSAVFWCALGALCFLFISSLFKPQHRKNQ*

Operon number 82:
potG: MVRLHTFNAGEQP*
potH: MTLSLARRRKPVRR*
potI: MVNMRWMMSA*

Operon number 83:
ybjQ: MSAFLTKCRTIYGVYWLIKALAILDGLTERTRRGMNATA*
amiD: MVIIPGGIAKQCRQFVAQIRAQGGDVVAAVQNAVVIKLLGHVIRASFNARTTACAVIFISWSDCGAGTEEQCAGDKHCQFAVAHNDFLISDRSESVLR*

Operon number 84:
macA: MVSSSVNCSPFLPSSFASCSPGVFKYKLNSSADIHSRSNA*
macB: MKSMVIHGVDFTIAYLNQTSIV*

Operon number 85:
clpS: MPADRAGILPLGCTQ*
clpA: MRLPLLLRRAQ*

Operon number 86:
lolA: MMTVGKKVEELIARLAQKARAAGIHLVLATQRPSVDVITGLIKANIPTRIAFTVSSKIDSRTILDQAGAESLLGMGDMLYSGPNSTLPVRVHGAFVRDQEVHAVVQDWKARGRPQYVDGITSDSESEGGAGGFDGAEELDPLFDQAVQFVTEKRKASISGVQRQFRIGYNRAARIIEQMEAQGIVSEQGHNGNREVLAPPPFD*
rarA: MHRMPDKAR*

Operon number 87:
dmsA: MLPF*
dmsB: MDPGTEHLP*
dmsC: MYTSLYSELL*

Operon number 88:
ycaI: MQSQLLTNRKMQTSPTTQWLKLSKQLKASNSLTLRDFYSEVC*
msbA: MQ*
lpxK: MQLLRSLQLTA*
ycaQ: MANIFRKRFVLDNNGQ*

Operon number 89:
ycaR: MI*
kdsB: MMSAISFRKQKQKSSCWITVRVAWEYSANSGWQITIG*

Operon number 90:
smtA: MAN*
mukF: MGRSRRSATGCKLNNKSASHPMLIKIFPVF*
mukE: MILRKSFPVTFTAPPKGSFDRLFCGRISIACWRKWARKNCVCWMLAVEKGRPQSKWPSVGIRSFYAIFLRR*
mukB: MLLRIWKRPLI*

Operon number 91:
ycbK: MAIR*
ycbL: MTRRTTICSSVIHAH*

Operon number 92:
elfD: MADNYCYY*
elfC: MCNVQRYGC*
elfG: MFLILFSHG*
ycbU: MRICYALCTLERRWRKTEKPFSSLAYGQSLQQRSGKREIP*
ycbV: MTTGRKRRNSTVNRKPSSVKRARCIELIDNTAC*
ycbF: MHKLKPGSILLFSKMIPQWWPICLVSKKDKK*

Operon number 93:
rlmL: MRSKARPLTSARACVRPMPRIDLTG*
uup: MTPSATVSTAR*

Operon number 94:
pqiA: MSKRWNCWKN*
pqiB: MSAVIMMPVVSKSSMWRSNSLR*
ymbA: MLPSSVSRMSRRKKCLLIWLLQSRSWSKPLNAGSILKR*

Operon number 95:
hyaA: MTDVIN*
hyaB: MNSFSFTRLATG*
hyaC: MVCLATGTSLADHKRPVSCRCRKEERRAI*
hyaD: MANISSQ*
hyaE: M*
hyaF: MSTEWAVR*

Operon number 96:
appC: MAGAQTSRRKVAGGQTGGWLRAAGVVAGGNAKSLADRFAVTAAH*
appB: MSVAGGSCTDVKRR*
yccB: MSLIYRAGSLL*

Operon number 97:

Operon number 98:
ymcE: MDLNFFTTVGGDNESFAAFAIKGFDNSCHFTGQTNSLLKILRCTIRG*

Operon number 99:
torC: M*
torA: MKNINSRCISRTPPACELNAMTVISRRIFQAW*
torD: MISTRPLLLTPLIHLKNSKPNARNLPSVNGRE*

Operon number 100:
efeO: MAGRW*
efeB: MSGSGRRWVQCSVLLLPWC*

Operon number 101:
ycdX: MLSVRCCIGFDVLTIIASSKIVRIGNRCLNIIGKILPSAFWAQAYWAVKLLRVCKPGAFRCVAGVEPVNRGLACKALPDGKNCLHF*
ycdY: MARISSTWRVVFMLWKMTCSRRWIAAKLKAQCWMFLIVNPYRLKVRSGNIHA*

Operon number 102:
ymdB: MAALFRKVLIC*
clsC: MNLERMVCCESANLKVWITQPSRMTNH*

Operon number 103:
opgG: MAVNIGIPTRSTRTFHHFFKG*
opgH: M*

Operon number 104:
rimJ: MRQ*
yceH: MKTTIATVRGRYPLWRIRRRASAYR*
yceM: M*

Operon number 105:
flgB: MPGETGLTG*
flgC: MAARMAVVDWALYE*
flgD: M*
flgE: MPIPLVIRRAISILPVNLKKSCNVDGMQPVWLH*
flgF: MLIA*

Operon number 106:
flgH: MPFPACWCFH*
flgI: MAINRCLKIVDHAILAIR*
flgJ: MPAVTVKLILALILCRAICRGCLVTLVPMSKPPVVTRSTERAGPMPAIPLAAR*

Operon number 107:
flgK: MTAGKGLGLAEMMVKQMTPEQPLPEESTPAAPMKFPLETVVRYQNQALSQLVQKAVPRNYDDSLPGDSKAFLAQLSLPAQLASQQSGVPHHLILAQAALESGWGQRQIRRENGEPSYNLFGVKASGNWKGPVTEITTTEYENGEAKKVKAKFRVYSSYLEALSDYVGLLTRNPRYAAVTTAASAEQGAQALQDAGYATDPHYARKLTNMIQQMKSISDKVSKTYSMNIDNLF*
flgL: MVSTFLVCSVSMMRLLPTSYVRRRRKVAV*

Operon number 108:
fabH: MH*
fabD: MLWSSVPMYWRAPAIQPIVGLLLFLAMARALRCWLPLKSRESFPPICMPTVVMVNC*
fabG: MRRWRRIILTVLNWTGWFRIRLTCVLSVQRRKNSVCLWIMSW*

Operon number 109:
pabC: MLVLEEYEHAKKRGAKIYAELVGFGMSSDAYHMTSPPENGAGAALAMANALRDAGIEASQIGYVNAHGTSTPAGDKAEAQAVKTIFGEAASRVLVSSTKSMTGHLLGAAGAVESIYSILALRDQAVPPTINLDNPDEGCDLDFVPHEARQVSGMEYTLCNSFGFGGTNGSLIFKKI*
yceG: MLPH*
tmk: MVVLPPPELSTVKSVCYRRISSDYRMLVSG*
holB: MVC*
ycfH: MRRWSLTAKGGLRNAVRLICSGGRAT*

Operon number 110:
hinT: MQPASSDGLVMA*
ycfL: MPEEGDERLYLVCE*
lpoB: MQMRNIRIHICHVNQTENVFSAHSQAEMGIMAIYTAAKRFFA*
thiK: MAQRMAI*
nagZ: MSWQKKLYSAKLFVVRSPPISSTRMIW*
ycfP: MSRRWDA*

Operon number 111:
lolC: MFQIRLSRQFPHGTLSI*
lolD: MTE*
lolE: MRLILRVMTRGVMGICLYWMIFQIKIRRQD*
nagK: MAI*

Operon number 112:
ymfL: MLRPVPMI*
ymfM: M*

Operon number 113:
ymfQ: MRWEGVSDGLKVTAGSVIQRDDLVQYTTTDDATSSGGVLRVPIACSSAGAVGNADDGTALILVTPVNGLPSSGVADTLTGGFDTEELETWRARVIERYYWTPQGGADGDYVVWAKEVPGITRAWTYRHLMGTGTVGVMIASSDLINPIPEESTETAARQHIGPLAPVAGSDLYVFRPVAHTVDFHIRVTPDTPEIRAAITAELRSFLLRDGYPQGELKVSRISEAISGANGEYSHQLLAPVDNISIAKNELAVLGTISWT*
stfP: MITSACYRHCCRPVRCGQPAIRRLPVRHRH*
tfaP: MP*

Operon number 114:

Operon number 115:
umuD: MPSSSTLMRMSFWADAFFSLYSSNSKIYAASNCVATPHHSYTVWVASKYLSWLSISKVLISPTKTEAACEYSCLKRLNSFMVSSKVCQGMT*
umuC: MSLFLLI*

Operon number 116:
dadA: MPIAGMSHHQRLHGNGVLFHQVSDTRVRVNDDFIGQSLLTVLIQPFSLDKLFTE*
dadX: MRSPSLIGSRGPPWKPVPRMPGKSPPDMLHRGRHQVCL*

Operon number 117:
prfA: MIIANRTRERAQILADEVGAEVIALSDIDERLREADIIISSTASPLPIIGKGMVERALKSRRNQPMLLVDIAVPRDVEPEVGKLANAYLYSVDDLQSIISHNLAQRKAAAVEAETIVAQETSEFMAWLRAQSASETIREYRSQAEQVRDELTAKALAALEQGGDAQAIMQDLAWKLTNRLIHAPTKSLQQAARDGDNERLNILRDSLGLE*
prmC: MNAMKKFRRCWVTRKLSPTRNVFAHYHANMRS*
ychQ: MFRAVLPTGNRFRKISKPHR*
ychA: MILKCVRWRRMNCAKLKKKASNWNSNYRFCYCQKILMTNVTPSSKSEPEPAATKRRCSRAICSVCTAVMPKPAAGG*
kdsA: MVVIKRSSPKLAVMVCMVV*

Operon number 118:
narG: MDRVKAEGGSDERAMREAATDTAAALGFISAIGAIGGFFIPKAFGSSLALTGSPVGAMKVFLIFYIACVVITWAVYGRHSKK*
narH: MCCGCVHSPQSLTLVSSWDSFTCRLPVNRII*
narJ: MMSRFFYASFSYNILMLYGLFRRISLRAINMLPMGNTP*
narI: MGMASFSIPTVTGRMDIASVGSMTKSSALPTG*

Operon number 119:
oppB: MCLDRGDTVRIDIR*
oppC: MLVNTSNYNEGVQKTMTNITKRSLVAAGVLAALMAGNVALAADVPAGVTLAEKQTLVRNNGSEVQSLDPHKIEGVPESNISRDLFEGLLVSDLDGHPAPGVAESWDNKDAKVWTFHLRKDAKWSDGTPVTAQDFVYSWQRSVDPNTASPYASYLQYGHIAGIDEILEGKKPITDLGVKAIDDHTLEVTLSEPVPYFYKLLVHPSTSPVPKAAIEKFGEKWTQPGNIVTNGAYTLKDWVVNERIVLERSPTYWNNAKTVINQVTYLPIASEVTDVNRYRSGEIDMTNNSMPIELFQKLKKEIPDEVHVDPYLCTYYYEINNQKPPFNDVRVRTALKLGMDRDIIVNKVKAQGNMPAYGYTPPYTDGAKLTQPEWFGWSQEKRNEEAKKLLAEAGYTADKPLTINLLYNTSDLHKKLAIAASSLWKKNIGVNVKLVNQEWKTFLDTRHQGTFDVARAGWCADYNEPTSFLNTMLSNSSMNTAHYKSPAFDSIMAETLKVTDEAQRTALYTKAEQQLDKDSAIVPVYYYVNARLVKPWVGGYTGKDPLDNTYTRNMYIVKH*
oppD: MGLYRDGAGNDRGCYPQFCGCTIISHDICDHFALAAGRWLEWWGA*
oppF: MMLSKKNSETLENFSEKLEVEGRSLWQDARRRFMHNRAAVASLIVLVLIALFVILAPMLSQFAYDDTDWAMMSSAPDMESGHYFGTDSSGRDLLVRVAIGGRISLMVGVAAALVAVVVGTLYGSLSGYLGGKVDSVMMRLLEILNSFPFMFFVILLVTFFGQNILLIFVAIGMVSWLDMARIVRGQTLSLKRKEFIEAAQVGGVSTSGIVIRHIVPNVLGVVVVYASLLVPSMILFESFLSFLGLGTQEPLSSWGALLSDGANSMEVSPWLLLFPAGFLVVTLFCFNFIGDGLRDALDPKDR*

Operon number 120:
yciV: MVARRSIKVCAGIWLR*
yciO: MSAIRKSPVHDARWQ*
yciQ: MAPPGKFLQRESLFATNALRHRTLHRSDYIHNAYAARKPLAAAARLRSVADVVRSGEQ*

Operon number 121:

Operon number 122:
yciS: MVARKSYPAVVVSTPRRS*
yciM: MSFVIC*

Operon number 123:
pyrF: MVL*

Operon number 124:
puuD: MSGLPANVRPGSAQADETTPQGVLRVFQHPLNFCFCDEALKLQQLIIFTGVIDMAEAFA*
puuR: MQNTGKNRCHHQIWVGIGTRHAIFHAVIMTVAARNTQGDGAVVMAPRRLRRHIHSRLEAAIRVHVWCQQRHRRRHQVNHPGEHLFQQRRIFAFRVRKHVLATIILHTDMDMHSAARVLFIRLRHKSGVHLMLFCHQTHQAF*

Operon number 125:
puuC: MTTIRICMQTKCLSNVKLSLQK*
puuB: M*
puuE: MEQ*

Operon number 126:
pspB: MRCAYQACKRRIDYVCRIKHSRRIRQVVLLNFAKSGAFSTTRGTDDKLTPVIQPRASGYISLVAN*
pspC: MFLWRAP*
pspD: MVGCRQRAPVHRTQSRAIISPAPSSVP*

Operon number 127:
ycjM: MKKEIGELENKLSETRARQQALMLRHQAANSSRDVRRQLDSGKLDEAMARFESFERRIDQMEAEAESHSFGKQKSLDDQFAELKADDAISEQLAQLKAKMKQDNQ*
ycjN: MKQNGCANVFRRWNLFLMQNIRTGGIANGGH*
ycjO: MAYSTAGHGPRRLRRDCQLF*
ycjP: MNTRWQQAGQKVKPGFKLAGKLVLLTALRYGPAGVAGWAIKSVARRPLKMLLAVALEPLLSRAANKLAQRYKR*
ycjQ: MAIFIHRRTLTCLKKAYLLWHWCFHCPFSPLNTGSMFVFQSSISKSTFRGPSIFP*
ycjR: MPDASQGKQKRSLARWDIPTLRTPVA*
ycjS: MAAKHFFTCSFVAVLSMVI*
ycjT: MQSFNV*
ycjU: MV*

Operon number 128:
ycjX: MQRWKIAPDWDVKLTDDLRFNGWLSMYKFANDLNTTGYADTRVETETGLQYTFNETVALRVNYYLERGFNMDDSRNNGEFSTQEIRAYLPLTLGNHSVTPYTRIGLDRWSNWDWQDDIEREGHDFNRVGLFYGYDFQNGLSVSLEYAFEWQDHDEGDSDKFHYAGVGVNYSF*
ycjF: MR*

Operon number 129:
ydaS: MYLLHC*
ydaT: MLILKYLGSFRLSFLPFLSWSPFPSQDCEHIFKSIIHYYQSNEYCFVYLRKKSLYLKISLKQEILLSLLLAVTRL*
ydaU: MFCFWYTSWQ*
ydaV: MF*

Operon number 130:
stfR: MVGPSVRVNEWFSAYAMAGMAYSRVSTFSGDYLRVTDNKGRCE*
tfaR: MKQITQLIEVMLVGRGGDQAVGQATLGIDTNVGLHAKVPLIAFLGLMHLRIALLLFVLGRAGCLNDGGIHQSALGHHDACFGQPAIDGLEQLTGQLMLLEQVAEIHDGGAIRQGAIQG*

Operon number 131:
ydbH: MSSSGEANCAMIGGSLSVARQLDGTAIGMCALPNGKRCSEQSLAAGSCGSY*
ynbE: MVLSSSLSCGLAHIIRVIASPLAVSSPLDSLPSPLKRLHMLPEIIIFSPKLISGGFLSLVTGLPFTLSSTKR*
ydbL: MQGSGKIKPVRSGRFRLFPDCLSFAA*

Operon number 132:
paaA: M*
paaB: MFTFSCTSARCSAFTSAPIFTPS*
paaC: MMAGIPPSHVGASFSSIPQQGKLKALICTATPDFEVSKWRAANPPSFDKGINSSSGHSVSSGSSRLPRLA*
paaD: MPPSISTQLSARVAPVCAERA*
paaE: MANWRAAAISRPSLVTSHNASPLIAW*
paaF: MFHISVANS*
paaG: M*
paaH: MPHFLWPVCQSNGENLQRREFSPASGV*
paaI: MSNVYWPLYEVFVRGKQGLSHRHVGSLHAADERMALENARDAYTRRSEGCSIWVVKASEIVASQPEERGEFFDPAESKVYRHPTFYTIPDGIEHM*
paaJ: MPLN*
paaK: MKIPWPSPETSASSATYCWLNNQTAILPTPLHASISSMHGMWRSLPV*

Operon number 133:

Operon number 134:
ynbA: MTLKMSKKR*
ynbB: MHIIGG*
ynbC: MMKML*
ynbD: MSVIR*

Operon number 135:
tehA: MKLPERKVPTVEGTMRKWSA*
tehB: MRCSKSCSRRASKRCKLS*

Operon number 136:
ydcS: MV*
ydcT: MKKYQQLAEQLREQIASGIWQPGDRLPSLRDQVALSGMSFMTVSHAYQLLESQGYIIARPQSGYYVAPQAIKMPKAPVIPVTRDEAVDINTYIFDMLQASRDPSVVPFASAFPDPRLFPLQQLNRSLAQVSKTATAMSVIENLPPGNAELRQAIARRYALQGITISPDEIVITAGALEALNLSLQAVTEPGDWVIVENPCFYGALQALERLRLKALSVATDVKEGIDLQALELALQEYPVKACWLMTNSQNPLGFTLTPQKKAQLVALLNQYNVTLIEDDVYSELYFGREKPLPAKAWDRHDGVLHCSSFSKCLVPGFRIGWVAAGKHARKIQRLQLMSTLSTSSPMQLALVDYLSTRRYDAHLRRLRRQLAERKQRAWQALLRYLPAEVKIHHNDSGYFLWLELPEPLDAGELSLAALTHHISIAPGKMFSTGENWSRFFRFNTAWQWGEREEQAVKQLGKLIQERL*
ydcU: MRGSSQPE*
ydcV: MGAEPADVQH*
patD: MDELVINAKSAGRCGGLVWLVTGSAGRV*

Operon number 137:
fdnG: MILVDQCHWLAVNCYCLSLNIPVL*
fdnH: MRKIDEIILFIDM*
fdnI: MQHKQILR*

Operon number 138:
lsrA: MVMVDA*
lsrC: MALKASVCPVAR*
lsrD: MPSRIEHAETAAIYSGAMPALCSAWRIHSHASCQFLLRSNSIEPGTSGTARCRHSACPTAI*
lsrB: MQI*
lsrF: MVFSALKGKPISSLCILIFVTTSPFASKK*
lsrG: MSPTAPFRPIINCSPWLI*

Operon number 139:
marR: MQTAQVGIMLTIYAWVVALMSLPFMLMTSQVERRKLLICLFVVFIASHVLSFLSWSFTVLVISRIGVAFAHAIFWSITASLAIRMAPAGKRAQALSLIATGTALAMVLGLPLGRIVGQYFGWRMTFFAIGIGALITLLCLIKLLPLLPSEHSGSLKSLPLLFRRPALMSIYLLTVVVVTAHYTAYSYIEPFVQNIAGFSANFATALLLLLGGAGIIGSVIFGKLGNQYASALVSTAIALLLVCLALLLPAANSEIHLGVLSIFWGIAMMIIGLGMQVKVLALAPDATDVAMALFSGIFNIGIGAGALVGNQVSLHWSMSMIGYVGAVPAFAALIWSIIIFRRWPVTLEEQTQ*

Operon number 140:
ydfA: MNCNYFCSHFCGDSPQNCQLPLLALSGH*

Operon number 141:
dicB: MPPVDASRDLRELNPLSSYKAKPNEYLLLVQVLFLNRNTKERQF*

Operon number 142:
ynfB: MLFIILLLTSSTACHLPDVRLVDKQVHRDISPPAFHRIRYQDPVCLPDAYSRYRKSSCAGRLRAFVRNNPCIPGHRNWGPTDQSAAPQPCRLVTNRKDRVSQYVPDTAKQNRQSGAYR*

Operon number 143:
ynfF: MAPYSPGHRCRAGCGYCLGID*
ynfG: MRNDCGHRKLYDLIGKICRHSAARPDDR*
ynfH: MVTTSVRQNACQRSGVTVLRRTEKNGYL*

Operon number 144:
ydgI: MMVCLCQEPHKLLMYELNVTPLK*
folM: MMLIRLFFKHRRSFEQD*

Operon number 145:
rstA: MAGLMVEMMGPWGEIIIAAGLIVSVCGAYLSWTIMAAEVPFLAATHKAFPRIFARQNAQAAPSASLWLTNICVQICLVLIWLTGSDYNTLLTIASEMILVPYFLVGAFLLKIATRPLHKAVGVGACIYGLWLLYASGPMHLLLSVVLYAPGLLVFLYARKTHTHDNVLNRQEMVLIGMLLIASVPATWMLVG*
rstB: MGKTQPLPILITGGGRRIGLALAWHFINQKQPVIVSYRTHYPAIDGLINAGAQCIQADFSTNDGVMAFADEVLKSTHGLRAILHNASAWMAEKPGAPLADVLACMMQIHVNTPYLLNHALERLLRGHGHAASDIIHFTDYVVERGSDKHIAYAASKAALDNMTRSFARKLAPEVKVNSIAPSLILFNEHDDAEYRQQALNKSLMKTAPGEKEVIDLVDYLLTSCFVTGRSFPLDGGRHLR*

Operon number 146:
malX: MMHRKSCLYFYFLPP*
malY: MPDHPVVEFRLQHG*

Operon number 147:
rsxA: MDQSREMWAVMNRLIELTGWIVLVVSVILLGVASHIDNYQPPEQSASVQHK*
rsxB: MLPVRVHVFTCRILNQEFIILFDVVGDCQG*
rsxC: MDLL*
rsxD: MSNKESSDRL*
rsxG: MTTTTPQRIGGWLLGPLAWLLVALLSTTLALLLYTAALSSPQTFQTLGGQALTTQILWGVSFITAIALWYYTLWLTIAFFKRRRCVPKHYIIWLLISVLLAVKAFAFSPVEDGIAVRQLLFTLLATALIVPYFKRSSRVKATFVNP*
rsxE: MNAIWIAVAAVSLLGLAFGAILGYASRRFAVEDDPVVEKIDEILPQSQCGQCGYPGCRPYAEAISCNGEKINRCAPGGEAVMLKIAELLNVEPQPLDGEAQEITPARMVAVIDENNCIGCTKCIQACPVDAIVGATRAMHTVMSDLCTGCNLCVDPCPTHCISLQPVAETPDSWKWDLNTIPVRIIPVEHHA*
nth: MAGCPGRKDYQLSVGSLCQ*

Operon number 148:
ydhI: MRNDRFLPLVVKHYLQINNHHECFVYNWLILLSL*
ydhJ: M*
ydhK: MLAWRFMVNRRFFND*

Operon number 149:
nemR: MTASVALPSLLTTSAGRSPKCPAPSGPSCLPVFCGSRCPPADSAALALPSLVAGWQLPLA*
nemA: MVTLPIDCPTPCDVTRFISTFSLAACAPVATTSARIARLKRFIGPPFIVHS*

Operon number 150:
ydiN: MNAYELQALRHIFAMTIDECATWIAQTGDSESWRQWENGKCAIPDRVVEQLLAMRQQRKKHLHAIIEKINNRIGNNTMRFFPDLTAFQRVYPDGNFIDWKIYQSVAAELYAHDLERLC*
ydiB: MKNPYFPTALGLYFNYLVHGMGVLLMSLNMASLETLWQTNAAGVSIVISSLGIGRLSVLLFAGLLSDRFGRRPFIMLGMCCYMAFFFGILQTNNIIIAYVFGFLAGMANSFLDAGTYPSLMEAFPRSPGTANILIKAFVSSGQFLLPLIISLLVWAELWFGWSFMIAAGIMFINALFLYRCTFPPHPGRRLPVIKKTTSSTEHRCSIIDLASYTLYGYISMATFYLVSQWLAQYGQFVAGMSYTMSIKLLSIYTVGSLLCVFITAPLIRNTVRPTTLLMLYTFISFIALFTVCLHPTFYVVIIFAFVIGFTSAGGVVQIGLTLMAERFPYAKGKATGIYYSAGSIATFTIPLITAHLSQRSIADIMWFDTAIAAIGFLLALFIGLRSRKKTRHHSLKENVAPGG*
aroD: MQYSWKHKLYAMYPGKIIFSIVIM*

Operon number 151:
ydiF: MDVTAKYELIGLMAYPIRHSLSPEMQNKALEKAGLPFTYMAFEVDNDSFPGAIEGLKALKMRGTGVSMPNKQLACEYVDELTPAAKLVGAINTIVNDDGYLRGYNTDGTGHIRAIKESGFDIKGKTMVLLGAGGASTAIGAQGAIEGLKEIKLFNRRDEFFDKALAFAQRVNENTDCVVTVTDLADQQAFAEALASADILTNGTKVGMKPLENESLVNDISLLHPGLLVTECVYNPHMTKLLQQAQQAGCKTIDGYGMLLWQGAEQFTLWTGKDFPLEYVKQVMGFGA*
ydiO: MKTVTVKDLVIGTGAPKIIVSLMAKDIASVKSEALAYREADFDILEWRVDHYADLSNVESVMAAAKILRETMPEKPLLFTFRSAKEGGEQAISTEAYIALNRAAIDSGLVDMIDLELFTGDDQVKETVAYAHAHDVKVVMSNHDFHKTPEAEEIIARLRKMQSFDADIPKIALMPQSTSDVLTLLAATLEMQEQYADRPIITMSMAKTGVISRLAGEVFGSAATFGAVKKASAPGQISVNDLRTVLTILHQA*

Operon number 152:
ydiQ: MRL*
ydiR: MASRSASVTAHQRGAGKTVLCTYRNGSH*

Operon number 153:
ydiS: ME*
ydiT: MPTPKSASSISMPLKLQASSQQMTMR*

Operon number 154:
ydjX: MPLLWLP*
ydjY: MPPAKSIYSFPC*
ydjZ: MFAL*
ynjA: M*
ynjB: MWVNKKNKKRNVMQK*
ynjC: MAATMKFVSFNINGLRARPHQLEAIVEKHQPDVIGLQETKVHDDMFPLEEVAKLGYNVFYHGQKGHYGVALLTKETPIAVRRGFPGDDEEAQRRIIMAEIPSLLGNVTVINGYFPQGESRDHPIKFPAKAQFYQNLQNYLETELKRDNPVLIMGDMNISPTDLDIGIGEENRKRWLRTGKCSFLPEEREWMDRLMSWGLVDTFRHANPQTADRFSWFDYRSKGFDDNRGLRIDLLLASQPLAECCVETGIDYEIRSMEKPSDHAPVWATFRR*
ynjD: MRRQKWNTTDFRTANRCVSMPITIR*

Operon number 155:

Operon number 156:
yeaP: MSYCQD*
yoaK: MQI*
yoaJ: MVCCN*

Operon number 157:
yeaV: MFRRAMLRNKFRRRAENTVIGRQFAGD*
yeaW: MFHQLRGLIPFQSIIGW*

Operon number 158:
pabB: MPLRLLANRGCRADPATLLSRSR*
nudL: MSG*

Operon number 159:
manY: MTICVTTTQKLA*
manZ: MTVNSGLVSVTIHEISDSSPRRIISASDNPSKRALSRCFGGSLSARMAMKTRLSIPSTISRTTSVSSPAQIEGSIKNSMTSSCLRNSYSTPEIMQA*

Operon number 160:
yebS: MRTGEARRYALTYRRMLRLFL*
yebT: MGCRQDRHALRRV*

Operon number 161:
yobB: MITSTTAPIAHSSLVIHTNQGAARSSSCLMRGTRT*
exoX: MTTIIITRMALSNKSWPQ*

Operon number 162:
znuC: MSRRVVDRFSGYAILCRPQPVG*
znuB: MSLVRRSQRPLA*

Operon number 163:
yecD: MPDLRAAEYRISERRAGSRISRAVPLR*
yecE: MRRPERAEPLRDLSDRSPDLQIQQTQQISADQQRQSVPSGYADPVYQNHNGVLLPQRSLPGNRPDPHPSLPATDDAPALPSLHALAARS*

Operon number 164:
cmoA: MLELNAKTTALVVIDLQEGILPFAGGPHTADEVVNRAGKLAAKFRASGQPVFLVRVGWSADYAEALKQPVDAPSPAKVLPENWWQHPAALGATDSDIEIIKRQWGAFYGTDLELQLRRRGIDTIVLCGISTNIGVESTARNAWELGFNLVIAEDACSAASAEQHNNSINHIYPRIARVRSVEEILNAL*
cmoB: MPATLTAWRATPRFTPCRNPRLSCAGVSRPQMTSASVLSFRRPFRIRQHYGIAMI*

Operon number 165:
fliD: MLPDAA*

Operon number 166:
yedE: MF*
yedF: MRRFSS*

Operon number 167:
fliF: MSLQKNYIL*
fliG: MSQHAISDYYLRRPG*
fliH: MEEVAKTPSEDLLSQVYYCGVQHI*
fliI: MLYPHFF*
fliJ: MRLLLLN*
fliK: MLFYRRFSIRCDFI*

Operon number 168:
fliL: MTALISEQHYARVRTFKQLLSSFQRNRDLVSVGAYAKGSDPMLDKAIALWPQLEGYLQQGIFERADWEASLQGLERIFPTVS*
fliM: MAEHGALATLKDLAEKEVEDAARLLGEMRRGCQQAEEQLKMLIDYQNEYRNNLNSDMSAGITSNRWINYQQFIQTLEKAITQHRQQLNQWTQKVDIALNSWREKKQRLQAWQTLQERQSTAALLAENRLDQKKMDEFAQRAAMRKPE*
fliN: MLHKIFSRC*
fliO: MKHRLSSTTNNPHQHR*
fliP: MI*
fliQ: MKTSPQA*
fliR: MRRQPCYRQRNQRSSQN*

Operon number 169:
yedY: MATMQIIMLLILYCSSMLCLAEANLATVTVNDGETSSILIRKASISVSLIMLL*
yedZ: MPAALIVSLAGMLFNMPSLTFVRLTILLMLSP*

Operon number 170:

Operon number 171:
hisG: MD*
hisD: MFTIRRGFSGKEASGMTSRSDQARKTQNIDRSTG*
hisC: MGQRAIH*
hisB: MNLFNNDNDMLQ*
hisH: MAFCGYL*
hisA: MIPQTRLVSLNDVLFRSFA*
hisF: MIFNGFHHCCRQILTRFAVANCTHVNLLFCTVHCTMMSVN*
hisI: MTRVQFKHHHHHHHPD*

Operon number 172:
mdtA: MEKKANLLSSSPRNTLLAAACHSSVGAPSVIRKIHGR*
mdtB: MAAPIGVSPWANRMGGKKLAALVKGCSTCTGPNVTMPSSTLFKASGSASSSSRKVTNPALSSLIGLPFIEPETSSSKMQGQRGSGLLAKSLVANVICSLIRNPFLENYRGPVSYRLQ*
mdtC: MQSIANA*
mdtD: MTKSTTMMSSFIMTLSLFMAPSSGGAFPFQRPAEIVGLPPFAMQAVYR*
baeS: MQVLPPSSTGGPSRLFIMRPVATTLLMVAILLAGIIGYRALPVSALPEVDYPTIQVVTLYPGASPDVMTSAVTAPLERQFGQMSGLKQMSSQSSGGASVITLQFQLTLPLDVAEQEVQAAINAATNLLPSDLPNPPVYSKVNPADPPIMTLAVTSTAMPMTQVEDMVETRVAQKISQISGVGLVTLSGGQRPAVRVKLNAQAIAALGLTSETVRTAITGANVNSAKGSLDGPSRAVTLSANDQMQSAEEYRQLIIAYQNGAPIRLGDVATVEQGAENSWLGAWANKEQAIVMNVQRQPGANIISTADSIRQMLPQLTESLPKSVKVTVLSDRTTNIRASVDDTQFELMMAIALVVMIIYLFLRNIPATIIPGVAVPLSLIGTFAVMVFLDFSINNLTLMALTIATGFVVDDAIVVIENISRYIEKGEKPLAAALKGAGEIGFTIISLTFSLIAVLIPLLFMGDIVGRLFREFAITLAVAILISAVVSLTLTPMMCARMLSQESLRKQNRFSRASEKMFDRIIAAYGRGLAKVLNHPWLTLSVALSTLLLSVLLWVFIPKGFFPVQDNGIIQGTLQAPQSSSFANMAQRQRQVADVILQDPAVQSLTSFVGVDGTNPSLNSARLQINLKPLDERDDRVQKVIARLQTAVDKVPGVDLFLQPTQDLTIDTQVSRTQYQFTLQATSLDALSTWVPQLMEKLQQLPQLSDVSSDWQDKGLVAYVNVDRDSASRLGISMADVDNALYNAFGQRLISTIYTQANQYRVVLEHNTENTPGLAALDTIRLTSSDGGVVPLSSIAKIEQRFAPLSINHLDQFPVTTISFNVPDNYSLGDAVQAIMDTEKTLNLPVDITTQFQGSTLAFQSALGSTVWLIVAAVVAMYIVLGILYESFIHPITILSTLPTAGVGALLALLIAGSELDVIAIIGIILLIGIVKKNAIMMIDFALAAEREQGMSPREAIYQACLLRFRPILMTTLAALLGALPLMLSTGVGAELRRPLGIGMVGGLIVSQVLTLFTTPVIYLLFDRLALWTKSRFARHEEEA*
baeR: MLPVAPLPQVDFPVIIVSASLPGASPETMASSVATPLERSLGRIAGVSEMTSSSSLGSTRIILQFDFDRDINGAARDVQAAINAAQSLLPSGMPSRPTYRKANPSDAPIMILTLTSDTYSQGELYDFASTQLAPTISQIDGVGDVDVGGSSLPAVRVGLNPQALFNQGVSLDDVRTAVSNANVRKPQGALEDGTHRWQIQTNDELKTAAEYQPLIIHYNNGGAVRLGDVATVTDSVQDVRNAGMTNAKPAILLMIRKLPEANIIQTVDSIRAKLPELQETIPAAIDLQIAQDRSPTIRASLEEVEQTLIISVALVILVVFLFLRSGRATIIPAVSVPVSLIGTFAAMYLCGFSLNNLSLMALTIATGFVVDDAIVVLENIARHLEAGMKPLQAALQGTREVGFTVLSMSLSLVAVFLPLLLMGGLPGRLLREFAVTLSVAIGISLLVSLTLTPMMCGWMLKASKPREQKRLRGFGRMLVALQQGYGKSLKWVLNHTRLVGVVLLGTIALNIWLYISIPKTFFPEQDTGVLMGGIQADQSISFQAMRGKLQDFMKIIRDDPAVDNVTGFTGGSRVNSGMMFITLKPRDERSETAQQIIDRLRVKLAKEPGANLFLMAVQDIRVGGRQSNASYQYTLLSDDLAALREWEPKIRKKLATLPELADVNSDQQDNGAEMNLVYDRDTMARLGIDVQAANSLLNNAFGQRQISTIYQPMNQYKVVMEVDPRYTQDISALEKMFVINNEGKAIPLSYFAKWQPANAPLSVNHQGLSAASTISFNLPTGKSLSDASAAIDRAMTQLGVPSTVRGSFAGTAQVFQETMNSQVILIIAAIATVYIVLGILYESYVHPLTILSTLPSAGVGALLALELFNAPFSLIALIGIMLLIGIVKKNAIMMVDFALEAQRHGNLTPQEAIFQACLLRFRPIMMTTLAALFGALPLVLSGGDGSELRQPLGITIVGGLVMSQLLTLYTTPVVYLFFDRLRLRFSRKPKQTVTE*

Operon number 173:
insE1: MI*
insF1: MA*

Operon number 174:
yegT: MCQAFRR*
yegU: MPEPHNRRAVRCSASALSIPRTFSYPVVCFRFQNIMKLFVFKYRDNDHKNDNMKIIRGVKGKKTASR*
yegV: MRCKHTWQCYVGMIRRFSVASGIGCRMQRKRLIRPTGWCCSYKAYQAIVILLSR*

Operon number 175:
yehL: MNNDMALIQLHHISQRAKSRPLRDNAAEFLQVVAENRGLSQEELADRLVPTLGLDDPQALSFDFGPRQFTVRFDENLNPVIFDQQNVRQKSVPRLRADDDQLKAPEALARLKGLKKDATQVSKNLLPRLETALRTTRRWSLADFHSLFVNHPFTRLVTQRLIWGVYPANEPRCLLKAFRVAAEGEFCNAQDEPIDLPADALIGIAHPLEMTAEMRSEFAQLFADYEIMPPFRQLSRRTVLLTPDESTSNSLTRWEGKSATVGQLMGMRYKGWESGYEDAFVYNLGEYRLVLKFSPGFNHYNVDSKALMSFRSLRVYRDNKSVTFAELDVFDLSEALSAPDVIFH*
yehM: MIVQKELVAIYDYEVPVPEDPFSFRLEIHKCSELFTGSVYRLERFRLRPTFHQRDREDADPLINDALIYIRDECIDERKLRGESPETVIAIFNRELQNIFNQEIE*
yehP: MLHRLWC*

Operon number 176:
yohJ: MCIASYNHWRKERAGGGQSPPPPAPPGSGEQNRRCAVPSAYPLRLPGRARGNIPVKRALSPHPCGLPRPSGNASAILTPPNNRAAY*
yohK: MVF*

Operon number 177:
sanA: MRDNYFADRTVPFPDYSGSNGLKFAMRRAFLMYVSRVA*

Operon number 178:
preT: M*
preA: MLKRVFLSLLVLIGLLLLTVLGLDRWMSWKTAPYIYDELQDLPYRQVGVVLGTAKYYRTGVINQYYRYRIQGAINAYNSGKVNYLLLSGDNALQSYNEPMTMRKDLIAAGVDPSDIVLDYAGFRTLDSIVRTRKVFDTNDFIIITQRFHCERALFIALHMGIQAQCYAVPSPKDMLSVRIREFAARFGALADLYIFKREPRFLGPLVPIPAMHQVPEDAQGYPAVTPEQLLELQKKQGK*

Operon number 179:
nfo: MTHRMFDCLGVT*
yeiI: M*

Operon number 180:
yeiR: MGRAD*

Operon number 181:
yejA: MNEPYWKKRYNEARRVLSRS*
yejB: MQSLGYPDELTESTA*
yejE: MMFPRLDPGYSPVIVIF*
yejF: MLS*

Operon number 182:
yejL: MVVLIDV*
yejM: MVKVSVAGSQKMRSPNSIASKLIVKPPPLPANFVN*

Operon number 183:
rcsD: MPLHTD*
rcsB: MFHLSL*

Operon number 184:
atoS: MALLNRLEMTCCKRIGSPFKATGTSGSIKQYKPNCLRTTSGK*
atoC: MWFITSRGENSRGSIFNCSDSIFEKSRISLIIFNNRLEELFIAVTSRSTPFGNSLVCNRSRLPIMPYSGVRSS*

Operon number 185:
atoD: MTAINRILIVDDEDNVRRMLSTAFALQGFETHCANNGRTALHLFADIHPDVVLMDIRMPEMDGIKALKEMRSHETRTPVILMTAYAEVETAVEALRCGAFDYVIKPFDLDELNLIVQRALQLQSMKKEIRHLHQALSTSWQWGHILTNSPAMMDICKDTAKIALSQASVLISGESGTGKELIARAIHYNSRRAKGPFIKVNCAALPESLLESELFGHEKGAFTGAQTLRQGLFERANEGTLLLDEIGEMPLVLQAKLLRILQEREFERIGGHQTIKVDIRIIAATNRDLQAMVKEGTFREDLFYRLNVIHLILPPLRDRREDISLLANHFLQKFSSENQRDIIDIDPMAMSLLTAWSWPGNIRELSNVIERAVVMNSGPIIFSEDLPPQIRQPVCNAGEVKTAPVGERNLKEEIKRVEKRIIMEVLEQQEGNRTRTALMLGISRRALMYKLQEYGIDPADV*
atoA: MQEG*
atoE: MKTKLMTLQDATGFFRDGMTIMVGGFMGIGTPSRLVEALLESGVRDLTLIANDTAFVDTGIGPLIVNGRVRKVIASHIGTNPETGRRMISGEMDVVLVPQGTLIEQIRCGGAGLGGFLTPTGVGTVVEEGKQTLTLDGKTWLLERPLRADLALIRAHRCDTLGNLTYQLSARNFNPLIALAADITLVEPDELVETGELQPDHIVTPGAVIDHIIVSQESK*
atoB: MRNNVLRAVWRKSFVMVTSLT*

Operon number 186:

Operon number 187:
glpA: MVMQNNQIVVFGHHQILFQIIRSLRIRHRFCWQRMLRQISTGTAMGDDYFFVAVRRHCTASHDYSAHHDRHAKVFQRQFHAISLRCVLAVIVHGDVFRQSSQQSTR*
glpB: MPPEWRRKQAYRAPHASH*
glpC: MAQSP*

Operon number 188:
yfaD: MV*

Operon number 189:
arnB: MQKPTAFRPDLLAQFFSLSPFPQAINQNSQSCGIVLPGTEDSMSEKKDLVTYCN*
arnC: MADDRGVFPGQWAISGGGVEPGERIEEALRREIREELGEQLLLTEITPWTFSDDIRTKTYADGRKEEIYMIYLIFDCVSANREVKINEEFQDYAWVKPEDLVHYDLNVATRKTLRLKGLL*
arnA: MTKPSR*
arnD: MVRTVLLE*
arnT: MMIYFFDFNEERQKANT*
arnE: MPQNFAKCKA*
arnF: MAKYTQHSL*

Operon number 190:
folX: MGMTVHQHIVLV*
yfcH: MTMRQKQTLFFQ*

Operon number 191:
gtrA: MHRFVTT*
gtrB: MAASLQD*
gtrS: MDCEERHLGWHRSCKGEKGFV*

Operon number 192:
yfdR: MAS*
yfdS: MF*
yfdT: MMRSSKMASERSTDVQAFIGELDGGVFETKIGAVLSEVASGVMNTKTKGKVSLNLEIEPFDENRLKIKHKLSYVRPTNRGKISEEDTTETPMYVNRGGRLTILQEDQGQLLTLAGEPDGKLRAAGH*

Operon number 193:
dsdX: MTTFTNKELIKEIKERISSLEVRDDIERRAYEIALVSLEVEPDEREAYELFMEKRFGDLVDRRRAKNGDNEYMAWDMTLGWIIWQQRAGIHFSTMSQQEVK*
dsdA: MRPVSFLKYPDLPSPS*

Operon number 194:
evgA: MLLISFSIGLVSITKALLV*
evgS: MEVTVEASSGISAMSSFFVSIVAVIDKPIRKGCSMSSFGSRETSTGTR*

Operon number 195:
ypdA: MPLVSFQF*
ypdB: MPTVKYRAFKVALPGVNSLYQV*
ypdC: MFAAGG*

Operon number 196:
yfeC: MLTICWSRPSVSGPLSTNSSSLPGN*
yfeD: MRRQQKLLPASCSGACSNARKLGRSVNGSVSACKCQRRLSHSLR*

Operon number 197:
yfeK: MISHLYQPMSPSVLNLIKQVIDASHAEGKWTGMCGELAGDERATLLLLGMGLDEFSMSAISIPRIKKIIRNTNFEDAKVLAEQALAQPTTDELMTLVNKFIEEKTIC*

Operon number 198:
murQ: MQGGNRGESDTDANRLRQCAAAINHILCTG*
murP: MEIAIVIAHIEETAQTTNACVIHQDINAPFFFLRAFDSCGYRRRVTHIGDNRRTAMTTTTQFVRQLFDLRGDIQQD*
yfeW: MTCKSSGNSFANSLQCARNQCCLAREFTHFNALLVNTERYTPFPLKIQDKQNIAADQLTNSGKSQSSRCFMHHFRRCVSSLLR*

Operon number 199:
amiA: MRVREFRFKSCQFVGKCFTGRTQGVNFPFHVGFDPNRRAAMFWQNATLNLRHCSS*
hemF: MRLIVP*

Operon number 200:
yffM: MDKPGGRNNHIAR*

Operon number 201:
yffO: MFATKDPEFENRINTNKSPRNAATCRGRYEKQAKGEFLMSDMLAVEQETNNDVRQFLNKINELRNKAPKNEETKHEEHTPDNHEETDHHEAKQQEQAWRGNLRYLDTLNRLDEVLPRKLYERWEKEHTVNDEAVLRALCYFAGTGKNSQLGWCRVGRGTIDKRARLSKNTVKKCLDRLVNHFKLVERTEGYIPGSAERECNEYQLLFKPYNMK*

Operon number 202:
yffQ: MPGNGSRNHKNC*
yffR: MAKITVFFIIYWGFYGRRTDRKQWVRHL*

Operon number 203:
talA: MFMIITHRTANHCIGFPTLNHDRADHCRVTDQRPLRLFLSDAATLHDLEVFGPVLFKARIGFVIDDLKINARFDLQAQFLNAHFDHVRTTDKDRFRQSQRYQFLSGMQNARLFPFRQNNALRRFASLGENRLHKQVGFVNELSQLVDVDVEISNRTSRHARLHRGFSDRRSDLNDQARIKRFWNDVFRTKAQILIAIR*
tktB: MGEFCNRTYRRQFHLFVDGGCANVQRATEDEREAQDVVHLVRIVRTTGANDGIRTHFFRQRRQNFRFRVRQRQDHWRTSHFLHHFLGQHFRAGTAQENIRAFNHIIEGTFAVIHHRICGFGFRHVWLTALIDNAF*

Operon number 204:
yffB: MKKTTSCRCLPPLVLALGVTGKTWRECLSA*
dapE: MR*
ypfN: M*

Operon number 205:
gcvR: MPGLDRSRPVPASRCQTAAYKLRPCCPANGCCRSLSCPLFPAPLADVAKPH*
bcp: MKRYRP*

Operon number 206:
hyfA: MLSDGFEMLIQTFLRRTIVVRGYRQAADDTTVIEALRQANGFRSSVSAGPGNYRNAPISQIQRHHHHISMFVMI*
hyfB: MIINQFFQASPTDITFFIHRSNNRDNTSREHGPSSVQTSVSMVRLVWH*
hyfC: MFFLCFP*
hyfD: MECHYSD*
hyfE: MYRTQCTRQY*
hyfF: MNPLKAGDIAPKFSLPDQDGEQVNLTDFQGQRVLVYFYPKAMTPGCTVQACGLRDNMDELKKAGVDVLGISTDKPEKLSRFAEKELLNFTLLSDEDHQVCEQFGVWGEKSFMGKTYDGIHRISFLIDADGKIEHVFDDFKTSNHHDVVLNWLKEHA*
hyfG: MTIIFVPFRIQLIHNLLNILS*
hyfH: MKCNVSYHFQGADMNRFVVAEPLWCTGCNTCLAACSDVHKTQGLQQHPRLALAKTSTITAPVVCHHCEEAPCLQVCPVNAISQRDDAIQLNESLCIGCKLCAVVCPFGAISASGSRPVNAHAQYVFQAEGSLKDGEENAPTQHALLRWEPGVQTVAVKCDLCDFLPEGPACVRACPNQALRLITGDSLQRQMKEKQRLAASWFANGGEDPLSLTQEQR*
hyfI: MPCNY*
hyfJ: MLV*
hyfR: MRWRNRISNGCWPGVPSKTSALFCWQSVWRWSVCHCTTRCSPWLDCSAHCFICSTMRCSKGCYFSARERLFRVCIPTTWKKWGH*
focB: MVLSANGTPGSRCSH*

Operon number 207:
yfgC: MTVMAKSRGVISWRTWLINALLVACGNLAGIACFSLLIWFSGLVMSENAMWGVAVLHCAEGKMHHTFTESVSLGIMCNLMVCLALWMSYCGRSLCDKIVAMILPITLFVASGFEHCIANLFVIPFAIAIRHFAPPPFWQLAHSSADNFPALTVSHFITANLLPVMLGNIIGGAVLVSMCYRAIYLRQEP*
yfgD: MRQCTE*

Operon number 208:
purM: MFSP*
purN: MANHSKRGV*

Operon number 209:
ppk: MNIVVLISGNGSNLQAIIDACKTNKIKGTVRAVFSNKADAFGLERARQAGIATHTLIASAFDSREAYDRELIHEIDMYAPDVVVLAGFMRILSPAFVSHYAGRLLNIHPSLLPKYPGLHTHRQALENGDEEHGTSVHFVTDELDGGPVILQAKVPVFAGDSEDDITARVQTQEHAIYPLVISWFADGRLKMHENAAWLDGQRLPPQGYAADE*

Operon number 210:
yfgH: MMP*
yfgI: MPGMRK*

Operon number 211:
hcaE: MCPLQ*
hcaF: MSVTPVHKH*
hcaC: MC*
hcaB: MAH*
hcaD: MQFFRRTGKVQCLRHCDEIA*

Operon number 212:
yfiP: MPVLPAESE*
pka: MPDGRVATRLIYQALF*

Operon number 213:
yfiR: MPRAPEHK*
yfiN: MRSIQQP*
yfiB: MQASVTDTPYFISLRGCSED*

Operon number 214:
ypjD: MLLIIFAIPPFFIFFIMRCMSSNCFRRRLTSCTCIPQPAAIRRLREPLMISGLARSFIVIELMMASIRTSTLSSICDLTLSGICPMPGSLPIRLAMPPIFFIWRSCSRKSLRSKPSPFFSLLANFSACARSTLLSISSISDSTSPMPRIRDAMRSGWNGSSASVFSPTPRNLIGLPVM*
yfjD: MASTTNRVSTGLIDAWTCLISSIIASSTCRRPAVSTSSTS*

Operon number 215:
rnlA: MSVYEYQTFLLVGEKPHPTIDRRYPRCACSGIS*
rnlB: MA*

Operon number 216:
ypjK: MAPVRTRCCRACSGRCARTVWSAASRLARCGCHTRGMW*
yfjS: MKCWGFLSVWKKRGMPCSRCFYRHLCSRHWQKQRLRIALVRTTSRLLNRRYSPHAAGRMRAMTFGPPISGFKKT*
yfjT: MLKADELILVPCVALTGM*

Operon number 217:
yfjX: MMGFIQGESADVMPKAASRLSLSKQDDKFMLASSVTDSQIKFKSNNAQLMVAFAFMPITTNGILHDYTYDIIINDKKYKIENHVAPLSRLDKNKKMKCEYQQISDLTNTYNINANYLTGFLLVLKPDDIINYNNSPSVLLKTDFAFYKKTYQKLDKIYDDISNGKLSSLRATGISQFSINGKHLSLRPESEIIISEGSLYGLVNKSKKIKIYGTADLVFVDNKIMNLRKITYLQSKLEIFGSSIMDILKYIFGLGLLAISIKFIHSYFKNDVNENLFL*
yfjY: MNHYF*

Operon number 218:
csiD: M*
lhgO: MGKPPCIKRKAFKWNA*
gabD: MERI*
gabT: MLLICCF*

Operon number 219:
gabP: MRWRKARAWFAAVKRTNAAATSSSRPFWWTFRPTPKCRKKRRSAPSPRCSALKMKLM*
csiR: MTPSLALPPISTPVI*

Operon number 220:
ygaV: MRKILRAEGSEIRLRMWLYPWLTWLVIGFITFVLVVMLFRPAQQLEVISTGLLAIGIICTVPIMARWKKLVLWQKTPVHNTR*
ygaP: MAIAG*

Operon number 221:
nrdH: MQYNRIKENIHHWCFLLLMYIVWHKKC*
nrdI: M*
nrdE: MYKKRAVTEYFIYKN*
nrdF: MRKCRWQ*

Operon number 222:
proV: MPDQRCRCRLRLE*

Operon number 223:
ygaZ: MN*
ygaH: MSSGCRCRSPHCRAIKTPIPNCRMVRIMASRSAPCISLPTKPGPRKTRQQRNCLPLCSCQWQILTPRTPLCMTAKPQKAIFRDTLMVGSKPTSSSSMAG*

Operon number 224:
emrA: MRPVWDSLLSKAFFSPASFMQARASSSLPRCWQPGVVCGLLH*
emrB: MFAMCCMARHCVAVLFSVCKNRKPPCGRLA*

Operon number 225:
srlA: MLRQRLFAYADHLRFGFVTVGDKSAFKPGGATGNIGNHFRYPTTGTRLGSCYGCATGFQRLPNLFT*
srlE: MVLALQFYEEDSEKS*
srlB: MGAVVVTGDGVEVRQTVPVLVAGANIQTQQAGLLMVAQRLLWR*
srlD: MPVAAEIYRILFVRRRHKLSVAHRPGKGTFQIERIVLLVARHQQEGFQLAREILRAAWVVK*

Operon number 226:

Operon number 227:
norV: M*
norW: MQVGDVGFQHPRAGSPVVMILCQCLTNSFTLERFCRFTQVLLNNGHRRHFWRRQRHLRKSKMLRLKNHFIAAAGGSRQNYRPMNSMFQFAHVSRKTVVLQ*

Operon number 228:
ascF: MPEQFCKIFRTSAPYGGVFLRSVVQVYYDRHKSAHESGKPPYTPGRLHDGCTGRIYWLRLCQPVHSDPRRCCGSPDVPPLPSHHTGKPQRRFCNQCNVPASHEQTLYHG*
ascB: MHSPDFPDEKPRTLLHRYGNQYIYSRQQ*

Operon number 229:
hypA: MISAITTNMPRLLAMTAQTAAAINILICKPLHFTCAWRCQSML*
hypB: MC*
hypC: MPMKCHFRHSSTRPSPNRRNACKTGKASAHAAGLCPFTSWLKFTGTLFSIAVYKLS*
hypD: MLTLPSIMPSMLSCACAIRCLSSPSFVST*
hypE: MVWLLKPSARVT*

Operon number 230:
ygbJ: MGRW*
ygbK: MLCYR*

Operon number 231:
ygbL: MVSSTIASADAQEIATALAGFDLEMLDAPVSGGAVKAANGEMTVMASGSDIAFERLAPVLEAVAGKVYRIGAEPGLGSTVKIIHQLLAGVHIAAGAEAMALAARAGIPLDVMYDVVTNAAGNSWMFENRMRHVVDGDYTPHSAVDIFVKDLGLVADTAKALHFPLPLASTALNMFTSASNAGYGKEDDSAVIKIFSGITLPGAKS*
ygbM: MILPARRISPVFWWKTVYQRYKLTVFQQVKCRKQSTHW*

Operon number 232:
ygcN: MLQQPGAHCRFARRR*
ygcO: MFQ*
ygcP: MWSPARAFLYGATGNYRGSRSAYGLDYRFR*

Operon number 233:
yqcE: MPRGVTFFTQRVFQHFQRNTTLRRRLHILNININDLIHGGAVEHHRVFYNSFQPTFGGGSTGTRHTVNFVRIHKIQHTGYLLCGTEFYDRCRNRQSINAMNIRKFTKTVNTVFL*
ygcE: ME*

Operon number 234:
yqcG: MVVYPRWRGELDRTASVVSSGSGLSPLARGTPVFANLWTIAIRFIPAGAGNTGARNTKPCICSVYPRWRGEHWLCNSSTHDHVGLSPLARGTRNAGER*

Operon number 235:
fucP: MSERIDTRRSFQRWRHTIHHVSVNKRHLRDIMRINANKLAPFLFVSDHVVNGHFCRSTCCGRNCQNRYTGFIGRGKPFQATHIGKLRVVADNANRFTSILWRTTTNSDQVIRAAILEYTEPFFDDSNCWVGHYAVVNRPCQPCSIHLIGHFRHHAALHQRFIGDDQRLLITTAFHLIG*
fucI: MRQP*

Operon number 236:

Operon number 237:
csdA: MRRCIATARPKIASV*
csdE: MVLLNTCAPKAPRATKMKPLMAAKISIKRLVMVVPYVNYCS*

Operon number 238:
yqeI: MDKCKKIMKVAYLIICISVLFFVFSCLLSIPPSYIEAAKEEGVTILSALSMLPNAPAWLSISGIIVAVVAMSKSFLGTYFGVIEGATEVVKTTLQQVGVKKSRAFNRALSIMLVSLITFIVCCINPNAISMIYAISGPLIAMILFIMPTLSTYLIPALKPWRSIGNLITLIVGILCVSVMFFS*
yqeJ: MVQNCYNFEPFHFS*

Operon number 239:
xdhA: MLNTDSLVTSAPVAWHVPHENIPASRRVNADFPFIKYSINRLLKA*
xdhB: MGKYYGEDKLERAKGIEPSYRAWEALVLPLNYARFEMRKAL*
xdhC: MQANRCRIRAPHSGDFLPSLHALPIIYQHRVIMGVSRNVIFTVFNHDEITVATQLVAHIHHLSCTRGVNRCTPWS*

Operon number 240:
ygfK: MFLYIAQPDCLYVVLLQRLKELALCNRILTLRKTVNEPDSPTTLRYVFKRPLRVANQRNEIAQLQGCIRC*
ssnA: MDIFCAHFRAQSMSSHHSNHAATAFGYARFVLIRRF*

Operon number 241:
ygfM: MPSLVGKISVPTRTINTGTTSIQRKSINVKAISLSRW*
xdhD: MSARTAPTSPLRSQASRTVSRRCTSTLTVTNAATALSSVRGTVNRTKTKSPSSAWRKTLITAATQASLWKIAGYEYV*

Operon number 242:
xanQ: MALTPPGRAPRGHETA*
guaD: MVVTETAKW*
ygfQ: MRHLVTRMAFHTGENTHCAGKNINNKWPLRRPVSLFER*

Operon number 243:
uacT: MGSQER*
yqfG: MRQICSHHPVSPHADENCIIFRS*

Operon number 244:
scpA: MKFHTHYIQKKRFRPRWQAAWLTHP*
argK: MPDSTYQALSSLLFVFLESHHKIDKSQAAKNDV*
scpB: MHFFCWRQTHVKSSP*
scpC: MSNVQEWQQLANKELSRREKTVDSLVHQTAEGIAIKPLYTEADLDNLEVTGTLPGLPPYVRGPRATMYTAQPWTIRQYAGFSTAKESNAFYRRNLAAGQKGLSVAFDLATHRGYDSDNPRVAGDVGKAGVAIDTVEDMKVLFDQIPLDKMSVSMTMNGAVLPVLAFYIVAAEEQGVTPDKLTGTIQNDILKEYLCRNTYIYPPKPSMRIIADIIAWCSGNMPRFNTISISGYHMGEAGANCVQQVAFTLADGIEYIKAAISAGLKIDDFAPRLSFFFGIGMDLFMNVAMLRAARYLWSEAVSGFGAQDPKSLALRTHCQTSGWSLTEQDPYNNVIRTTIEALAATLGGTQSLHTNAFDEALGLPTDFSARIARNTQIIIQEESELCRTVDPLAGSYYIESLTDQIVKQARAIIQQIDEAGGMAKAIEAGLPKRMIEEASAREQSLIDQGKRVIVGVNKYKLDHEDETDVLEIDNVMVRNEQIASLERIRATRDDAAVTAALNALTHAAQHNENLLAAAVNAARVRATLGEISDALEVAFDRYLVPSQCVTGVIAQSYHQSEKSASEFDAIVAQTEQFLADNGRRPRILIAKMGQDGHDRGAKVIASAYSDLGFDVDLSPMFSTPEEIARLAVENDVHVVGASSLAAGHKTLIPELVEALKKWGREDICVVAGGVIPPQDYAFLQERGVAAIYGPGTPMLDSVRDVLNLISQHHD*

Operon number 245:
rsmE: MAAGMGVLGTMMHIGIHSPSAQYFAIAMLLMFIVGFAMSAGPLIWVLCSEIQPLKGRDFGITCSTATNWIANMIVGATFLTMLNTLGNANTFWVYAALNVLFILLTLWLVPETKHVSLEHIERNLMKGRKLREIGAHD*
gshB: METFRPRSATWQRVEVDDGKRAGCSRPSYASVRTAIRASQHLPLPLQVPGASAYRTPP*

Operon number 246:
yqgE: MNASRRCRAIITRMCNALARRERANLH*
yqgF: MRIPRIYHPEPLTSHSHIALCEDAANHIGRVLRMGPGQALQLFDGSNQVFDAEITSASKKSVEVKVLEGQIDDRESPLHIHLGQVMSRGEKMEFTIQKSIELGVSLITPLFSERCGVKLDSERLNKKLQQWQKIAIAACEQCGRNRVPEIRPAMDLEAWCAEQDEGLKLNLHPRASNSINTLPLPVERVRLLIGPEGGLSADEIAMTARYQFTDILLGPRVLRTETTALTAITALQVRFGDLG*

Operon number 247:
yggS: MNQSVWINRLCSAVRWLKIAGLFCILRPPILLPAFAFQTTR*
yggT: MCWKRSAPINNRLTYWWLWVMPPGRKVNWNKKFSITRG*
yggU: MNPPVAQLPARHHAYVMLPAPNARFLPPSVPDGLSRCHAALRAKSHQDLPAMRPAIPMRTSYSANQFPAAGSNIAGWHRDIQQDLPASEYAHRHVD*
rdgB: MRCHAIAGFPPATRQNPADHSPAILPADRHPATPAVALRRPAYQTAQLPFCRECAIVRARRCTGVDPRRYALH*
yggW: MNDIAHNLAQVRDKISAAATRCGRSPEEITLLAVSKTKPASAIAEAIDAGQRQFGENYVQEGVDKIRHFQELGVTGLEWHFIGPLQSNKSRLVAEHFDWCHTIDRLRIATRLNDQRPAELPPLNVLIQINISDENSKSGIQLAELDELAAAVAELPRLRLRGLMAIPAPESEYVRQFEVARQMAVAFAGLKTRYPHIDTLSLGMSDDMEAAIAAGSTMVRIGTAIFGARDYSKK*

Operon number 248:
mutY: MFFGAFADFLHADQTFPGQITAAVKGQFVRFDNLVNKIINGFINLFFRCTFRESPCHRKS*

Operon number 249:
qseB: MLIQNT*
qseC: MRLGIAFFVTRKRIYTSPKNFACLFLGKRELFSNLHYKFRCHCFGIHRSPKCLYLRHESI*

Operon number 250:

Operon number 251:
ygiB: MTHLPVE*
ygiC: MTKSIKI*

Operon number 252:
insC1: MHRQTIPLPWRMVSAICSTVMVSAGKIISPSFSRSSSSSTITPRPSRSAASAFSTRSKGVPKEESSV*
insD1: MVKKPH*

Operon number 253:

Operon number 254:
yqiJ: MLNMKVEIPLSLVTYQESLSPAMVKKVIKSGKAVNIL*
yqiK: MFSVIMHYQAHLQEKNTHLHGQI*

Operon number 255:
ttdA: MVCSQS*
ttdB: MCVLSTDSSLNTNFQNGTAYECNRAWNDPHRVPLRLHFQCHSGLPLVWAARSANQRLRQSRRNQCVTYRWQGSSRSSTDFRRSERNVARLGRV*

Operon number 256:
ebgA: MATLKDIAIEAGVSLATVSRVLNDDPTLNVKEETKHRILEIAEKLEYKTSSARKLQTGAVNQHHILAIYSYQQELEINDPYYLAIRHGIETQCEKLGIELTNCYEHSGLPDIKNVTGILIVGKPTPALRAAASALTDNICFIDFHEPGSGYDAVDIDLARISKEIIDFYINQGVNRIGFIGGEDEPGKADIREVAFAEYGRLKQVVREEDIWRGGFSSSSGYELAKQMLAREDYPKALFVASDSIAIGVLRAIHERGLNIPQDISLISVNDIPTARFTFPPLSTVRIHSEMMGSQGVNLVYEKARDGRALPLLVFVPSKLKLRGTTR*

Operon number 257:
ygjJ: MLRMPSSDTNIL*
ygjK: MLIKQNNKK*

Operon number 258:
yqjA: MAGKYAVCAGCRCTG*

Operon number 259:
yqjC: MTTIKSSRR*
yqjD: MLLSWQCGSIWKTPRSCYLTKPATTSSSMPTAIYSPKTRWCISIQPPAAVNEIPVRQALQCACLSRR*
yqjE: MFLNAFLSHDLTGNSSGCVDVSNPQNIPKQQ*
yqjK: MNGTFDPIAASPVGAGF*

Operon number 260:
yhaK: MNNLLMFI*
yhaL: MSLYKLPIKNNHVFILNIKTFITSEKERYE*

Operon number 261:
yhaB: MPVL*
yhaC: MSSIATGRSYVICIIKPLRLN*

Operon number 262:
prlF: MRPGPHFNNPWLENIAQWPTSKSDKKRQLRFI*
yhaV: MWQLLLMIMA*

Operon number 263:
kbaZ: MLALTLY*
agaV: MNRRIIL*

Operon number 264:
agaS: MNA*
kbaY: MRLPKIRYNKT*

Operon number 265:
agaB: MILQPDSVMDQNRWSMTKRWWWYLSPATLTPVSMILICWLNFAVTTRQCV*
agaC: MATRCLLLTFITPRRSKRSSKCAVKCDRR*
agaD: MIFAVKSTQVCAVR*
agaI: MT*

Operon number 266:
yraI: MGGSAINDARHLRNFPATAYRAAAGAT*
yraJ: MRSRIGEKRSSWAERTGRKPATGLPYQST*
yraK: MAAQ*

Operon number 267:
lpoA: MMLR*
yraN: MTAWILKPHYRQTTFQDSQPTRLSLLTPDSHR*
diaA: MDPLILVRTPPLPCMSPSHFSAR*
yraP: MEWEARLQVTSMI*

Operon number 268:
yhbU: MLFCQPTADGDECFHCCSLLYCGPDLNMRRRR*
yhbV: MSNAAISSTKAAKGRKHCAGKEN*

Operon number 269:
yrbG: MLSNVA*
kdsD: MDVTFAAFRQTNSAASSAANKKIPTQISFFFVCMNSIPKHQCGQHKIQPQNSQRRVDNGASGCPANPGRRRDGVVAVKQRNPRHRDGEHHALNQTVDQIHTPVDGILHCRPEEPAINAFPTDADQRSAPDPHGDENNRQQW*
kdsC: MFAKFRFADQRIE*
lptC: MSERRQRI*
lptA: MAREVGYVRAVDRRRCQIRSYQ*
lptB: MAP*

Operon number 270:
rpoN: MSKARRWVIIVLSLAVLVMIGINMAEKDDTAQVVVNNNDPTYKSEHTDTLVYNPEGALSYRLIAQHVEYYSDQAVSWFTQPVLTTFDKDKIPTWSVKADKAKLTNDRMLYLYGHVEVNALVPDSQLRRITTDNAQINLVTQDVTSEDLVTLYGTTFNSSGLKMRGNLRSKNAELIEKVRTSYEIQNKQTQP*

Operon number 271:
yhbJ: MPLMKPVI*
npr: MKRSTSTKLKPSLSGSNGLIRSVWRQKICVTVC*

Operon number 272:
gltB: MLST*
gltD: MVTAICTTMARTTRASASNIEKRTRPNFIIRST*

Operon number 273:
yhcA: MKRTCRVPAAK*
yhcD: MR*

Operon number 274:
accB: MHMRTTYAGVTFRTAGRQNSRISTDSGRKSPAGGRCHGRCSLVEPEL*
accC: MMALIS*

Operon number 275:
yhdT: MLDKIVIANRGEIALRILRACKELGIKTVAVHSSADRDLKHVLLADETVCIGPAPSVKSYLNIPAIISAAEITGAVAIHPGYGFLSENANFAEQVERSGFIFIGPKAETIRLMGDKVSAIAAMKKAGVPCVPGSDGPLGDDMDKNRAIAKRIGYPVIIKASGGGGGRGMRVVRGDAELAQSISMTRAEAKAAFSNDMVYMEKYLENPRHVEIQVLADGQGNAIYLAERDCSMQRRHQKVVEEAPAPGITPELRRYIGERCAKACVDIGYRGAGTFEFLFENGEFYFIEMNTRIQVEHPVTEMITGVDLIKEQLRIAAGQPLSIKQEEVHVRGHAVECRINAEDPNTFLPSPGKITRFHAPGGFGVRWESHIYAGYTVPPYYDSMIGKLICYGENRDVAIARMKNALQELIIDGIKTNVDLQIRIMNDENFQHGGTNIHYLEKKLGLQEK*
panF: MDTRFVQAHKEARWALGLTLLYLAVWLVAAYLSGVAPGFTGFPRWFEMACILTPLLFIGLCWAMVKFIYRDIPLEDDDAA*

Operon number 276:
dusB: MTSFWVLVCFGVIGLPHTAVRCISYKDSKAVHRGIIIGTIVVAILMFGMHLAGALGRAVIPDLTVPDLVIPTLMVKVLPPFAAGIFLAAPMAAIMSTINAQLLQSSATIIKDLYLNIRPDQMQNETRLKRMSAVITLVLGALLLLAAWKPPEMIIWLNLLAFGGLEAVFLWPLVLGLYWERANAKGALSAMIVGGVLYAVLATLNIQYLGFHPIVPSLLLSLLAFLVGNRFGTSVPQATVLTTDK*
fis: MR*

Operon number 277:
acrE: MYIMNSTENMPFIDLQCRKLFTIKSRIVWSYDSSGVQAKKHYGSMYEPILMMVKDAKNYTFNGDAILVEAKTGSQRALIDYRKNPPQPYNHQKVPGNVWDFPRVRYLMDEYENHPTQKPEALLKRIILASSNPGDIVLDPFAGSFTTGAVAIASGRKFIGIEINSEYIKMGLRRLDVASHYSAEELAKVKKRKTGNLSKRSRLSEVDPDLITK*
acrF: MCKPGFQIIHFVYISCQTWLNMHRLR*

Operon number 278:
yhdX: MAFSSLIRELTY*
yhdY: MTIRVVWFTPIPV*
yhdZ: MWRMFHFRTIAGRCFYYFLSTLSLLRREIVRKSWHYFCL*

Operon number 279:
def: MQGKPAPPEL*
fmt: MLN*

Operon number 280:
rsmB: MNAARAVLLQQTVRRGNLSSPEVEEDKIRCPQELNDGWVAPTNKVSFRYSFVEMKESVVPAAM*
trkA: MPSPVKVLAEEKGLPVFQPVSLRPQENQQLVAELQADVMVVVAYGLILPKAVLEMPRLGCINVHGSLLPRWRGAAPIQRSLWAGDAETGVTIMQMDVGLDTGDMLYKLSCPITAEDTSGTLYDKLAELGPQGLITTLKQLADGTAKPEVQDETLVTYAEKLSKEEARIDWSLSAAQLERCIRAFNPWPMSWLEIEGQPVKVWKASVIDTATNAAPGTILEANKQGIQVATGDGILNLLSLQPAGKKAMSAQDLLNSRREWFVPGNRLV*

Operon number 281:
gspC: MRGLTSFPARESLPRCYHA*
gspD: MRSRANSDLPMFVKKHSHFYMPAPLLLPDRTRPNQLGPRTPIRRITRLAPHYRASPHEQYP*
gspE: MRPYLARKQRGLK*
gspF: MNGLRHERTQ*
gspG: MGE*
gspH: MPTIHARITPTSADV*
gspI: MNYRYRAMTQDGQKLQGIIDANDERQARLRLREEGLFLLDIRPQKSSGVKTRRPRISHSELTLFTRQLATLSAAALPLEESLAVIGQQSSNKRLGDVLNQVRSAILEGHPLSDALQHFPTLFDSLYRTLVKAGEKSGLLAPVLEKLADYNENRQKIRSKLIQSLIYPCMLTTVAIGVVIILLTAVVPKITEQFVHMKQQLPLSTRILLGLSDTLQRTGPTLLATVFIVAVGFWLWLKRGNNRHRFHAMLLRVALIGPLICAINSARYLRTLSILQSSGVPLLDGMNLSTESLNNLEIRQRLANAAENVRQGNSIHLSLEQTAIFPPMMLYMVASGEKSGQLGTLMVRAADNQETLQQNRIALTLSIFEPALIITMALIVLFIVVSVLQPLLQLNSMIN*
gspJ: MRATDKQRGFTLLEIMVVIVIIGVLASLVVPNLMGNKEKADKQKAVSDIVALENALDMYKLDNHHYPTTNQGLESLVEAPTLPPLAANYNKEGYIKRLPADPWGNDYVLVNPGEHGAYDLLSAGPDGEMGTEDDITNWGLSKKKK*
gspK: MAHYGTGQNTISLALGSITRRCRRREPK*
gspL: MAPGSNARQRYPPMNKQSGMTLLEVLLAMSIFTAVALTLMSSMQGQRNAIERMRNETLALWIADNQLQSQDSFGEENTSSSGKELINGEEWNWRSDIHSSKDGTLLERTITVTLPSGQTTSLTRYQSIDNKSGQAQDD*
gspM: MNNAASRCSLYSCYWRSWLLWQQT*
gspO: MILNWRRNLRLPASPRTLKITTDRPRCSSTGHSHNSCSWKMAIQ*

Operon number 282:
yheS: MGIKHPEVE*
yheT: MAIFTFRQQHARNKCTERHRQPQRIHKQCGTQHQQQRRGGEHFPHARSCNKAEYRTQ*
yheU: MFVCRPRQQRH*

Operon number 283:
crp: MLIPWQDLSPETLENLIESFVLREGTDYGEHERTLEQKVADVKRQLQCGEAVLVWSELHETVNIMPRSQFRE*
yhfK: MELLCLPNIRSLR*

Operon number 284:
nirB: M*
nirD: MTNSNRIKLTWISFLSYALTGALVIVTGMVMGNIADYFNLPVSSMSNTFTFLNAGILISIFLNAWLMEIVPLKTQLRFGFLLMVLAVAGLMFSHSLALFSAAMFILGVVSGITMSIGTFLVTQMYEGRQRGSRLLFTDSFFSMAGMIFPMIAAFLLARSIEWYWVYACIGLVYVAIFILTFGCEFPALGKHAPKTDAPVEKEKWGIGVLFLSVAALCYILGQLGFISWVPEYAKGLGMSLNDAGTLVSNFWMSYMVGMWAFSFILRFFDLQRILTVLAGLAAILMYVFNTGTPAHMAWSILALGFFSSAIYTTIITLGSQQTKVPSPKLVNFVLTCGTIGTMLTFVVTGPIVEHSGPQAALLTANGLYAVVFVMCFLLGFVSRHRQHNTLTSH*

Operon number 285:
nirC: MPMRKHCVWRKPAWVAPGAATALATASASAWNWKTATKASVRRTK*
cysG: MFAVTAA*

Operon number 286:
frlA: MLTLVEGPFDESLLDTCWLAIAATDDDALNQRVSEAAEARRIFCNVVDAPKAASFIMPSIIDRSPLMVAVSSGGTSPVLARLLREKLESLLPLHLGQVAKYAGQLRGRVKQQFATMGERRRFWEKLFVNDRLAQSLANNDQKAITETTEQLINEPLDHRGEVVLVGAGPGDAGLLTLKGLQQIQQADVVVYDRLVSDDIMNLVRRDADRVFVGKRAGYHCVPQEEINQILLREAQKGKRVVRLKGGDPFIFGRGGEELETLCNAGIPFSVVPGITAASGCSAYSGIPLTHRDYAQSVRLITGHLKTGGELDWENLAAEKQTLVFYMGLNQAATIQQKLIEHGMPGEMPVAIVENGTAVTQRVIDGTLTQLGELAQQMNSPSLIIIGRVVGLRDKLNWFSNH*
frlB: MTLFIYSANKT*

Operon number 287:
frlC: MALLAGISATSWSYTGMASICYMTGEIKNPGKTMPRALIGSCLLVLVLYTLLALVISGLMPFDKLANSETPISDALTWIPALGSTAGIFVAITAMIVILGSLSSCVMYQPRLEYAMAKDNLFFKCFGHVHPKYNTPDVSIILQGALGIFFIFVSDLTSLLGYFTLVMCFKNTLTFGSIIWCRKRDDYKPLWRTPAFGLMTTLAIASSLILVASTFVWAPIPGLICAVIVIATGLPAYAFWAKRSRQLNALS*
frlD: MTFRWCTPSWKRW*

Operon number 288:
yrfG: MPKATTS*
hslR: MRIPLN*
hslO: MPCNLFRQRRRRFAGKRVSKSSYSIFAKKRMKNMR*

Operon number 289:
feoA: MHLETELMGTVRERAEDEAINVFARNLHDLLMAAPAGLRATMGLDPGLRTGVKVAVVDATGKLVATDTIYPHTGQAAKAAMTVAALCEKHNVELVAIGNGTASRETERFYLDVQKQFPKVTAQKVIVSEAGASVYSASELAAQEFPDLDVSLRGAVSIARRLQDPLAELVKIDPKSIGVGQYQHDVSQTQLARKLDAVVEDCVNAVGVDLNTASVPLLTRVAGLTRMMAQNIVAWRDENGQFQNRQQLLKVSRLGPKAFEQCAGFLRINHGDNPLDASTVHPEAYPVVERILAATQQALKDLMGNSSELRNLKASDFTDEKFGVPTVTDIIKELEKPGRDPRPEFKTAQFADGVETMNDLQPGMILEGAVTNVTNFGAFVDIGVHQDGLVHISSLSNKFVEDPHTVVKAGDIVKVKVLEVDLQRKRIALTMRLDEQPGETNARRGGGNERPQNNRPAAKPRGREAQPAGNSAMMDALAAAMGKKR*
feoB: MRNK*
feoC: MQYTPDTAWKITGFSREISPAYRQKLLSLGMLPGSSFNVVRVAPLGDPIHIETRRVSLVLRKKDLALLEVEAVSC*

Operon number 290:
insA: MARVK*
insB1: MRMKYLHSHS*

Operon number 291:

Operon number 292:
nikA: METPQPDKTGMHILLKLASLVVILAGIHAAADIIVQLLLALFFAIVLNPLVTWFIRRGVQRPVAITIVVVVMLIALTALVGVLAASFNEFISMLPKFNKELTRKLFKLQEMLPFLNLHMSPERMLQRMDSEKVVTFTTALMTGLSGAMASVLLLVMTVVFMLFEVRHVPYKMRFALNNPQIHIAGLHRALKGVSHYLALKTLLSLWTGVIVWLGLELMGVQFALMWAVLAFLLNYVPNIGAVISAVPPMIQVLLFNGVYECILVGALFLVVHMVIGNILEPRMMGHRLGMSTMVVFLSLLIWGWLLGPVGMLLSVPLTSVCKIWMETTKGGSKLAILLGPGRPKSRLPG*
nikB: MYRIVLGKVSTLSAAPLPPGLREQAPQGPRRERWLAGRALLSHTLSPLPEIIYGEQGKPAFAPEMPLWFNLSHSGDDIALLLSDEGEVGCDIEVIRPRANWRWLANAVFSLGEHAEMDAVHPDQQLEMFWRIWTRKEAIVKQRGGSAWQIVSVDSTYHSSLSVSHCQLENLSLAICTPTPFTLTADSVQWIDSVN*
nikC: MPLHQMKSPPPGR*
nikD: MSGH*
nikE: MNHW*
nikR: MVKPGPSPCVMT*

Operon number 293:
rhsB: MQNPRSAFNPLHTMHTHARETCLALGKPADDATLTAAIEAVGLENAARVLKLYPFEMSGGMLQRMMIAMAVLCESPFIIADEPTTDLDVVAQARILDLLESIMQKQAPGMLLVTHDMGVVARLADDVAVMSDGKIVEQGDVETLFNAPKHTVTRSLVSAHLALYGMELAS*
yhhH: MRTVDLTENINIRRC*

Operon number 294:
arsB: MYTAVTTHRQPCRMKLVCVGSEEKIVGIHGIGFGMDEMLQGFAVALKMGATKKDFDNTVAIHPTAAEEFVTMR*
arsC: MLKG*

Operon number 295:
mdtE: MSWYRQRSMKGSWLQLVIGVLDIVIAWIFLGATPMVSVTLVSTLVGIELIFSAASLFSFASLFVKQQ*
mdtF: MIRLILSPLRSVVDQLRTIIEIITC*

Operon number 296:
bcsE: MIPRINRRAPALK*
bcsF: MR*
bcsG: MMHSRLAFSARSSSTGTSSPASVSLQPPAHHCDIHLLVA*

Operon number 297:

Operon number 298:
insJ: MEKMKQG*
insK: MTG*

Operon number 299:
xylG: MAHVTCGKTQMRHLLYASPTPVPHQAAATDD*
xylH: MLTGLRILSLHNERDRAGQNRLAY*

Operon number 300:
yiaK: MYAHELRTRAGEN*
yiaL: MLKFWHLSKALCDRAQVIPDSKSQFIRNSLRGFTQWFQEIFLSHLFQT*

Operon number 301:
yiaM: MVAQSVP*
yiaN: MKVTFEQLKAAFNRVLISRGVDSETADACAEMFARTTESGVYSHGVNRFPRFIQQLENGDIIPDAQPKRITSLGAIEQWDAQRSIGNLTAKKMMDRAIELAADHGIGLVALRNANHWMRGGSYGWQAAEKGYIGICWTNSIAVMPPWGAKECRIGTNPLIVAIPSTPITMVDMSMSMFSYGMLEVNRLAGRQLPVDGGFDDEGNLTKEPGVIEKNRRILPMGYWKGSGMSIVLDMIATLLSDGASVAEVTQDNSDEYGISQIFIAIEVDKLIDGPTRDAKLQRIMDYVTSAERADENQAIRLPGHEFTTLLAENRRNGITVDDSVWAKIQAL*
yiaO: MNHL*
lyxK: MFTDQVVLCKQPLRYEKLWLKSH*
yiaQ: MVFRQAFYLLMNCHVIYLSG*
yiaR: MPLVCPPASLSHSLNCVIYINSSRVAIL*
yiaS: MD*

Operon number 302:
rhsA: ML*
yibA: MDISLQAFL*

Operon number 303:

Operon number 304:
lldP: MQ*
lldR: MLAKPCEAF*
lldD: ML*

Operon number 305:
gpmM: MAGYDDENITAGCQRSGEIAFKMERIGKRHIGEKRGVTAVAFKRCDMFRVMAPEDNLVAISCQGDGKSGAVRAGTDHSH*
envC: MNSASKLTGARFSCGNVPRDTMLVMHSRAYGNRMFGQYAPRQCAIWVPSIPAMEKIPPC*
yibQ: MCRKPLSVVLKYCAM*

Operon number 306:
hldD: MMIDFTALI*
waaF: MMPKHHFSYLSWYQNATH*
waaC: MTKMPWSSSTMLLFSVIF*
waaL: MKSKTCC*

Operon number 307:
waaA: MLLEIGDLLIGQHHKFRRFTLLESRSLKCGIMAIS*
coaD: MLFEMILYPGIIFCIASMVGMGLNWHLNKLKCFRAIAFPRLCIYPNMVAPCGNC*

Operon number 308:
dfp: MRRLPDIPK*
dut: MIIQPSGSSSSRYLARRCTLSTGWSLKR*

Operon number 309:
rpoZ: MAGFWLFRRSYNYAIGDEG*
spoT: MPLALEKYFPLKRTVG*
trmH: MGNRMHNRTI*
recG: MAAPCIISSYVGFISLITYERYSWLKARFILFLPPVARVNPA*

Operon number 310:
rpmH: MVTSFSCNASKSRSASRTKSMVIARPVKLALAMTRFSAPSSSRTLDRRRLAIKNATSPGKRMSFSSAFFIRIATRVSSSGGSIATVSPQPKRDFKRSSTPLISFG*
rnpA: MIC*
yidD: MS*
yidC: MPLPTACSR*

Operon number 311:
mdtL: MERLAVGLYDGMNLDWLAYRIAQVQYLVDGLEEIGVVCQQAGGHAAFVDAGKLLPHIPADQFPAQALACELYKVAGIRAVEIGSFLLGRDPKTGKQLPCPAELLRLTIPRATYTQTHMDFIIEAFKHVKENAANIKGLTFTYEPKVLRHFTAKLKEV*
yidZ: MTDQAEKKHSAFWGVMVIAGTVIGGGMFALPVDLAGAWFFWGAFILIIAWFSMLHSGLLLLEANLNYPVGSSFNTITKDLIGNTWNIISGITVAFVLYILTYAYISANGAIISETISMNLGYHANPRIVGICTAIFVASVLWLSSLAASRITSLFLGLKIISFVIVFGSFFFQVDYSILRDATSSTAGTSYFPYIFMALPVCLASFGFHGNIPSLIICYGKRKDKLIKSVVFGSLLALVIYLFWLYCTMGNIPRESFKAIISSGGNVDSLVKSFLGTKQHGIIEFCLLVFSNLAVASSFFGVTLGLFDYLADLFKIDNSHGGRFKTVLLTFLPPALLYLIFPNGFIYGIGGAGLCATIWAVIIPAVLAIKARKKFPNQMFTVWGGNLIPAIVILFGITVILCWFGNVFNVLPKFG*

Operon number 312:
yieE: MEYADRDSDCL*
chrR: MRCRNRSTNVTRRRPSNYVTGITIP*

Operon number 313:
rbsD: MFVRPVWFWR*
rbsA: M*
rbsC: MLVYPSPKVQRVSIWH*
rbsB: MKCRSRRPLSRKRSNTIIRNSTKRCSLTLSSCKNTREIPLKFVTPRMNNSNNKPQKVRR*

Operon number 314:
rbsK: MEQKSLIALLVLIAIVSTLSPNFFTINNLFNILQQTSVNAIMAVGMTLVILTSGIDLSVGSLLALTGAVAASIVGIEVNALVAVAAALALGAAIGAVTGVIVAKGRVQAFIATLVMMLLLRGVTMVYTNGSPVNTGFTENADLFGWFGIGRPLGVPTPVWIMGIVFLAAWYMLHHTRLGRYIYALGGNEAATRLSGINVNKIKIIVYSLCGLLASLAGIIEVARLSSAQPTAGTGYELDAIAAVVLGGTSLAGGKGRIVGTLIGALILGFLNNGLNLLGVSSYYQMIVKAVVILLAVLVDNKKQ*
rbsR: MNMKKLATLVSAVALSATVSANAMAKDTIALVVSTLNNPFFVSLKDGAQKEADKLGYNLVVLDSQNNPAKELANVQDLTVRGTKILLINPTDSDAVGNAVKMANQANIPVITLDRQATKGEVVSHIASDNVLGGKIAGDYIAKKAGEGAKVIELQGIAGTSAARERGEGFQQAVAAHKFNVLASQPADFDRIKGLNVMQNLLTAHPDVQAVFAQNDEMALGALRALQTAGKSDVMVVGFDGTPDGEKAVNDGKLAATIAQLPDQIGAKGVETADKVLKGEKVQAKYPVDLKLVVKQ*

Operon number 315:
ilvM: MVTL*
ilvE: MNNSTKFCFSRFRTGN*

Operon number 316:
ilvD: MAATVFSGTIQRNHPY*
ilvA: MMQHQVNVSARFNPETLERVLRVVRHRGFHVCSMNMAAASDAQNINIELTVASPRSVDLLFSQLNKLVDVAHVAICQSTTTSQQIRA*

Operon number 317:
wecA: MRSEQISGSSLNPSCRFSSAYSPVTRQRKDMSR*
wzzE: MDDPAIPFTTLSSRFTPSLRTHTTMNLTELKNTPVSELITLGENMGLENLARMRKQDIIFAILKQHAKSGEDIFGDGVLEILQDGFGFLRSADSSYLAGPDDIYVSPSQIRRFNLRTGDTISGKIRPPKEGERYFALLKVNEVNFDKPENARNKILFENLTPLHANSRLRMERGNGSTEDLTARVLDLASPIGRGQRGLIVAPPKAGKTMLLQNIAQSIAYNHPDCVLMVLLIDERPEEVTEMQRLVKGEVVASTFDEPASRHVQVAEMVIEKAKRLVEHKKDVIILLDSITRLARAYNTVVPASGKVLTGGVDANALHRPKRFFGAARNVEEGGSLTIIATALIDTGSKMDEVIYEEFKGTGNMELHLSRKIAEKRVFPAIDYNRSGTRKEELLTTQEELQKMWILRKIIHPMGEIDAMEFLINKLAMTKTNDDFFEMMKRS*

Operon number 318:
wecB: MTVLISA*
wecC: MRSTWLMALMACWAGCPASRLQQSV*
rffG: MRAVR*
rffH: MDIALSVPGKLLALLSA*
wecD: MDYWHGAGVCVNRAGVYVFCSSGVELDGDYRSSNGEYAGGILLAAAIFA*
wecE: MGGAYHPDESSGEASGRGGESHLRPPDEQH*
wzxE: M*
wecF: MRWQKILFLRLKFASLRSIGRCSIRC*
wzyE: MHCYGCVTR*
wecG: M*

Operon number 319:
yifL: MTRQRRSAIRWCISISVSWMSSALARIKIAW*
dapF: MYRYRNWKTPSSFMARFRITNCTACQCRLKPITSNYRRWWTALPAKGSSSSFSKKRKTRMALISTFSTKATGLRYITTAKAAKRSWYVTSVASTRHRMTVLPTAQASSTSTCRSSIRL*
yigA: MVVNR*
xerC: MQS*
yigB: MILLPFSKVMVSTPPLISQSISLSPSQSSRRSSMVSQS*

Operon number 320:
pldB: MVMTN*
yigL: MAWAVIKAMNIG*

Operon number 321:
ubiE: MKWNLQPC*
yigP: MLRR*
ubiB: MR*

Operon number 322:
tatA: MRGGAKFLHHGIKRQQRYVAEAITEEWRMAPGPLEVAWFAEETAAVERAVDALTKRLEKLEAK*
tatB: MN*
tatC: MASWRSSRLKLQWAACR*

Operon number 323:
pepQ: MASR*
yigZ: MTA*
trkH: MPTTSSRYAGPIGQPNCFSITLSILRKSAPSRSSWLKPAKYGNSTRLTKKPGQSLTTIGVLPILLAQATTFAMVSSELFSPRIISTNGIRWTGLKKCIPQKFSGRSSALASSLIGMVEVLDASTVSWRTFCSVSASTAFFTFGFSTTASTTISTRSNPA*
hemG: MPRVNDLSLISFMTTGTPFHADW*

Operon number 324:
rdoA: MVVWGLLMRE*
dsbA: MPDATLARLIQPTLAYPFCFCIHSTTKSASPSTSLISSNATSRLSGTSLATAITCLSITNSSGRCPAPSRNSTIFAISSCLNPSTRIKSSFEVSIRLARNCRSSSSSSGVSVIKAHRCWLATMVCAAPALRSS*

Operon number 325:
yihL: MITVSTSLIPRGTPTSVVKLNV*
yihM: MLALSALAASSAVK*

Operon number 326:
yihV: MPRLHGLPGIPMRPPSLPRVRHAGTVFRRHRKRGSPMAY*
yihW: MRA*

Operon number 327:
yihX: MNASQNV*
yihY: MTMIRVACVGITVMDRIYYVEGLPTESGKYVARNYTEVGGGPAATAAVAAARLGAQVDFIGRVGDDDTGNSLLAELESWGVNTRYTKRYNQAKSSQSAIMVDTKGERIIINYPSPDLLPDAEWLEEIDFSQWDVVLADVRWHDGAKKAFTLARQAGVMTVLDGDITPQDISELVALSDHAAFSEPGLARLTGVKEMASALKQAQTLTNGHVYVTQGSAGCDWLENGGRQHQPAFKVDVVDTTGAGDVFHGALAVALATSGDLAESVRFASGVAALKCTRPGGRAGIPDCDQTRSFLSLFV*
dtd: MVFRGIFMSLTELTGNPRHDQLLMLIAERGYMNIDELANLLDVSTQTVRRDIRKLSEQGLITRHHGGAGRASSVVNTAFEQREVSQTEEKKAIAEAVADYIPDGSTIFITIGTTVEHVARALLNHNHLRIITNSLRVAHILYHNPRFEVMVPGGTLRSHNSGIIGPSAASFVADFRADYLVTSVGAIESDGALMEFDVNEANVVKTMMAHARNILLVADHTKYHASAAVEIGNVAQVTALFTDELPPAALKSRLQDSQIEIILPQEDA*
yiiD: M*

Operon number 328:
yiiS: MPQHPEFSVPRRSDVRKLLQFCPLHFQLRFHRCTEPESGPALSAPRIFSRSVRQILCGKYDVQSDR*
uspD: MRRTGSGPRFAHPA*

Operon number 329:
metB: MIVLKLYF*
metL: MT*

Operon number 330:
frwC: M*
frwB: MFAQGSIASQGSVSFQNRAGSTVAIQQTKLNVFQYQRQAVFQCGLLGVNAFGCGKITQRIEI*

Operon number 331:
pflD: M*
pflC: MLPVYRKL*
frwD: MAFLSTVCSACDCLLFPPSKIWTWAFASPGAAYE*

Operon number 332:
argC: MVSPSTLPSILTLLRNAEYCSFILPQTPHLIV*
argB: MEMLKNRPK*

Operon number 333:
fabR: MGLFICRALSRNHAALLAWFIVLAHRCAAAMSSWQRPSAQEWMAISIKF*
yijD: MPTICARARCLNWARPTSYGTFIAVSCCSVLPTELISGMV*

Operon number 334:
btuB: MKQANQDRGTLLLALVAGLSINGTFAALFSSIVPFSVFPIISLVLTVYCLHQRYLNRTMPVGLPGLAAACFILGVLLYSTVVRAEYPDIGSNFFPAVLSVIMVFWIGAKMRNRKQEVAE*
murI: MLAHPAWVLLRGQ*

Operon number 335:
murB: MTRHYGAEATNALLPGKASKHQVTSNRTPNRHRWSGREYQGA*
birA: MELKSVEDTSWLQLFIKNTALCKHESGRIRCDACPVPEG*

Operon number 336:
secE: MA*
nusG: MMRVRFPLPAPRCADIAQLVERTLGKGEVGSSNLPISTTSFLLPVFSFCLLHSTSRACCLVDVVISPIYPCLRGTIDV*

Operon number 337:
rplK: MFVENF*

Operon number 338:
nudC: MMGEAPFRHNRTAARDDTGQAFRGHRHIAQQYARMDSEVIHTLLGLFQQRVAERFPGKIFGDPVNLLQRLVDRHCTDRHRAVTQNPLAGFVNIATGGEIHHRIRSPARGPYQLFHFFFDGRGDRRVADIGVNFYQEIATNNHRLRFRMINVGRDNRTSGSNFITDKFRSDIFRQMCAKAHSRMLVA*
hemE: MLGPGALFAAGQFCCRHSSFQKVKDVACQTTDEARDDRRRGDAIAD*
nfi: MNKNYGCRRENCHMAKRQISILWVSAHYKSANGRGNLFG*

Operon number 339:
hupA: MVYCVKTTVAAYRSRCLPKAADSGWKPWQKPVAMRWASTGQRTSPMRAAVWAIKSRCRVIWIRRCCTRRLPALKKK*
yjaH: MSLTLVTAFIRMCRQNMLACSWRQCIDCLNSITAKE*

Operon number 340:
zraS: MGHSVGNIPTFS*
zraR: MAGSARRFAITVSGKL*

Operon number 341:
aceB: MKWSLGQR*
aceA: MRNQRYSVIVRSWQCLSRNNRVTIGGY*

Operon number 342:
yjbF: MHFVSNVDGTHIAEVLKKVNPETTLFLVASKTFTTQETMTNAHSARDWFLKAAGDEKHVAKHFAALSTNAKAVGEFGIDTANMFEFWDWVGGRYSLWSAIGLSIVLSIGFDNFVELLSGAHAMDKHFSTTPAEKNLPVLLALIGIWYNNFFGAETEAILPYDQYMHRFAAYFQQGNMESNGKYVDRNGNVVDYQTGPIIWGEPGTNGQHAFYQLIHQGTKMVPCDFIAPAITHNPLSDHHQKLLSNFFAQTEALAFGKSREVVEQEYRDQGKDPATLDYVVPFKVFEGNRPTNSILLREITPFSLGALIALYEHKIFTQGVILNIFTFDQWGVELGKQLANRILPELKDDKEISSHDSSTNGLINRYKAWRG*
yjbG: MPICTSYSAINT*
yjbH: MSAFFYQINPLVCNLTEIIP*

Operon number 343:
ubiC: MMWCKEII*
ubiA: MGCQV*

Operon number 344:
lexA: MTCS*
dinF: MVIDSVPVFGSSKRPVRERPPSTKYSTE*

Operon number 345:
yjbL: MNVQGAALATVIAEYATLLIGLLMVRKILKLRGISGEMLKTAWRGNFRRLLALNRDIMLRSLLLQLCFGAITVLGARLGSDIIAVNAVLMTLLTFTAYALDGFAYAVEAHSGQAYGARDGSQLLDVWRAACRQSGIVALLFSVVYLLAGEHIIALLTSLTQIQQLADRYLIWQVILPVVGVWCYLLDGMFIGATRATEMRNSMAVAAAGFALTLLTLPWLGNHALWLALTVFLALRGLSLAAIWRRHWRNGTWFAAT*
yjbM: MGQTDR*

Operon number 346:
yjbQ: MQESRLELPSLQ*
yjbR: MIFLMPSFYVRDNKRC*

Operon number 347:
nrfB: MLIICGISVKCRGIGSFV*
nrfC: MQLCMLLKKRKILTNSKVVFYMHLQLIKDNIHSVVICYT*
nrfD: MS*

Operon number 348:
nrfE: MYKVGEQNSVCMSCHLPEQLQKAFWPHDVHVTKVACASCHSLHPQQDTMQTLSDKGRIKICVDCHSDQRTNPNFNPASVPLLKEQP*
nrfF: MGCVTAWCMTSRYASAVPPVWMLVGK*
nrfG: M*

Operon number 349:
yjdA: MKS*
yjcZ: MRRKRLIRPTDGAGICRPDKTRKRRIRQLALLPDAA*

Operon number 350:
yjdI: MLPPRFSTCCLTSAKPTPRSLPFVETPLSKM*

Operon number 351:
yjdK: MAPMITPLLRTGTVLISNSRSLIVISSSRRGVPSRNTSETSTTCDHEWLSVDSFSSSCDLR*
yjdO: MAWRCSNSVEIS*

Operon number 352:
yjeN: MPDCSGVALGVDRLVMLALGAETLAEVIAFSVDRA*
yjeO: MFSFFR*

Operon number 353:
nnr: MLRRYYAANAGDQYDESPILP*
tsaE: MARRWHRSGKSSYRPRICRILPRLVDPRAAEYRPAIRLKRRTNRPRD*
amiB: MRR*
mutL: MLAVWARTR*
miaA: MCWGSHSMS*

Operon number 354:
hflK: MCTIETYRAQFFQNRKVQSTNKHIRKRENG*
hflC: METKAVAIKGHLI*

Operon number 355:
nsrR: MNEFDNLAGACPGFGTGRFRADALPEGMEEDDLCDDQFAR*
rnr: MLYATRAVTTQAILS*

Operon number 356:
yjfI: MLQTMLLRSMKQAIYDPENRGHFGLALQSYAHFTSPIRRYPDLTLHRAIKYLLAKEQGHQGNTTETGGYHYSMEEMLQLGQHCSMAERRADEATRDVADWLKCDFMLDQVGNVFKGVISSVTGFGFFVRLDDLFIDGLVHVSSLDNDYYRFDQVGQRLMGESSGQTYRLGDRVEVRVEAVNMDERKIDFSLISSERAPRNVGKTAREKAKKGDAGKKGGKRRQVGKKVNFEPDSAFRGEKKTKPKAAKKDARKAKKPSAKTQKIAAATKAKRAAKKKVAE*
yjfJ: MRFVHAGCGVNALSGLHNHANSIYCRDHVGRINVVHQAKRKQRVH*

Operon number 357:
yjfK: MRMLQEENIWIVGTAGEADHTLYQSKMTGRLALVMGAEGEGMRRLTREHCDELISIPMAGSVSSLNVSVATGICLFEAVRQRS*
yjfL: MKSHPDLDGFFLSIAGKIITYCKYSFY*
yjfM: ME*
yjfC: MTWNPLALATALQTVPEQNIDVTNSENALIIKMNDYGDLQINILFTSRQMIIETFICPVSSISNPDEFNTFLLRNQKMMPLSSVGISSVQQEEYYIVFGALSLKSSLEDILLEITSLVDNALDLAEITEEYSH*

Operon number 358:
ulaA: MFLIDQVICQR*
ulaB: MQIHRRPARALLGNSFCAIAHFFQFAAFVKFIDIASRSGRRNSQTLNDFLNGHKAQLCEHFQEDLMSLCFSHELFR*
ulaC: MPSGSTPAAF*
ulaD: MSFTFTTSPGLTTMQRSFGTPQPIHKSTQVFGPINGTSSAQFCITAAATLTSI*
ulaE: MRCIW*
ulaF: M*

Operon number 359:

Operon number 360:
tamA: MFRHLILQALLIFVEIKPNHVFTRCH*
tamB: MPIRPTQSLQYIEFGRFCRPGKSFTPHQA*
ytfP: MLPAADRRQFRQFHSNHTGFYADIAGGHLRHNKTVWR*

Operon number 361:
chpS: MRRCPWRFRH*
chpB: MDRCR*

Operon number 362:
ytfR: MDRTSRWT*
ytfT: MSSLVFVFIFLFHQF*
yjfF: MKAITNL*

Operon number 363:
lptF: MRRCCVLSGLRVQCCVGRIRRSRRIRQ*
lptG: MGQRIMVRHQTSNMMTQRDHAGTGQRRHVNHRFRLKTLNVS*

Operon number 364:
insC1: MPEIQCLSIFPAILTLSRSTDINVHLPTYVGTDDGISGSIMLVPTGREYDGINRYQSQSSQANG*
insD1: MGDRTHFADLYSVQ*

Operon number 365:
yjhB: MFRHFNHLISHQIISQ*
yjhC: MTVQIPHFSSGEAHGVRHRRQQMADFSFARHGQQAGSHFISQSRPLFSCLRAGFQLHQMIAFTQFSDLFILRSLSERYHPVAVFSRQAPGI*

Operon number 366:
fimI: MMQAVCYGATGARDYCLILLAYRHGMRISELLDLHYQDLDLNEGRINIRRLKNGFSTVHPLRFDEREAVERWTQERANWKGADRTDAIFISRRGSRLSRQQAYRIIRDAGIEAGTVTQTHPHMLRHACGYELAERGADTRLIQDYLGHRNIRHTVRYTASNAARFAGLWERNNLINEKLKREEV*
fimC: M*

Operon number 367:
fimD: MPTLVR*
fimF: MRLGKIAHRCLLLFIYGNVARW*
fimG: MVKIRMCFPWERGQG*
fimH: MMKETSYRLIVLQQTGNGFIQALLRYISSPNIVLPGVGLLAASPMPRPGSL*

Operon number 368:
yjjQ: MNEKGDNFYSNTRRRGGCLSSVCLSEAILYARALAVQP*
bglJ: MRQIPARPLNTNGTDQHRSHKG*

Operon number 369:
holD: MKNQGRNKKGSKDNWCEGGDLNPHVRKDTNT*
rimI: MRGQMPDATLARLIWPTKG*
yjjG: MARYTLKRPVCAITSWKPNVSSSTSG*

Operon number 370:
yjjU: MWW*
yjjV: MSQSTLPLPAG*

Operon number 371:
radA: MSRRNVDITISFLVVMGHSFFSLSSSSGTGLLAVNRKGDCCQRVRLPCSSVRVSTTPIASESSNIRRKMLVVLSTCWASVASVWVSSVRRR*
nadR: MRFSSGESVRISGATFSVT*

Operon number 372:
creA: MAGSFAEDLVKCLQNGLNFSGIGGRTDNLVHNQHYSEN*
creB: MLQVYLVRHGETQWNAERRIQGQSDSPLTAKGEQQAMQVATRAKELGITHIISSDLGRTRRTAEIIAQACGCDIIFDSRLRELNMGVLEKRHIDSLTEEEENWRRQLVNGTVDGRIPEGESMQELSDRVNAALESCRDLPQGSRPLLVSHGIALGCLVSTILGLPAWAERRLRLRNCSISRVDYQESLWLASGWVVETAGDISHLDAPALDELQR*
creC: MHVPYTVRINSCTPVPRPS*

